Aachen	—
Aarau	—
Abbild	Abbilder
Abc	Abc
Abchasien	—
Abendblatt	Abendblätter
Abendbrot	Abendbrote
Abendessen	Abendessen
Abendkleid	Abendkleider
Abendland	Abendländer
Abendmahl	Abendmahle
Abendprogramm	Abendprogramme
Abenteuer	Abenteuer
Aber	Aber	Abers
Abführmittel	Abführmittel
Abgas	Abgase
Abgehen	Abgehen
Abgeordnetenhaus	Abgeordnetenhäuser
Abhören	Abhören
Abi	Abis
Abitur	Abiture
Abkommen	Abkommen
Abladen	Abladen
Ableben	Ableben
Ablenkungsmanöver	Ablenkungsmanöver
Abo	Abos
Abonnement	Abonnements	Abonnemente
Abschleppen	Abschleppen
Abschluss	Abschlüsse
Abschlusstraining	Abschlusstrainings
Abschneiden	Abschneiden
Abseits	Abseits
Abstellgleis	Abstellgleise
Abstimmungsergebnis	Abstimmungsergebnisse
Abstimmungsverhalten	Abstimmungsverhalten
Abteil	Abteile
Abwasser	Abwässer
Abzeichen	Abzeichen
Achtelfinale	Achtelfinale	Achtelfinals
Ackerland	—
Acryl	—
Adagio	Adagios
Ade	Ades
Aden	—
Adieu	Adieus
Adjektiv	Adjektive
Afghanistan	—
Afrika	—
Aggregat	Aggregate
Agrarprodukt	Agrarprodukte
Aki	Akis
Akkordeon	Akkordeons
Aktenzeichen	Aktenzeichen
Aktienkapital	Aktienkapitale	Aktienkapitalien
Aktienpaket	Aktienpakete
Aktionsprogramm	Aktionsprogramme
Aktivum	Aktiva	Aktiven
Alabama	—
Alaska	—
Albanien	—
Album	Alben
Ale	Ales
Alexandria	—
Algerien	—
Algier	—
Alibi	Alibis
Alkoholproblem	Alkoholprobleme
All	—
Allegro	Allegros	Allegri
Allheilmittel	Allheilmittel
Alltagsleben	Alltagsleben
Almosen	Almosen
Alpenland	Alpenländer
Alpha	Alphas
Alphabet	Alphabete
Altenheim	Altenheime
Altersheim	Altersheime
Altertum	Altertümer
Altpapier	Altpapiere
Aluminium	—
Ambiente	—
Amen	Amen
Amerika	Amerikas
Amin	Amine
Amman	—
Ammoniak	—
Amphetamin	Amphetamine
Amt	Ämter
Amtsblatt	Amtsblätter
Amtsenthebungsverfahren	Amtsenthebungsverfahren
Amtsgericht	Amtsgerichte
Amtsjahr	Amtsjahre
Anabolikum	Anabolika
Anatolien	—
Anbaugebiet	Anbaugebiete
Andalusien	—
Andante	Andanta
Andenken	Andenken
Andorra	—
Anforderungsprofil	Anforderungsprofile
Angebot	Angebote
Angeln	Angeln
Angesicht	Angesichter
Angola	—
Ankara	—
Anklopfen	Anklopfen
Anliegen	Anliegen
Anmeldeformular	Anmeldeformulare
Anrecht	Anrechte
Ansagen	Ansagen
Ansinnen	Ansinnen
Anstarren	Anstarren
Antibiotikum	Antibiotika
Antiquariat	Antiquariate
Antlitz	Antlitze
Antwerpen	—
Anwesen	Anwesen
Anzeichen	Anzeichen
Apartment	Apartments
Appartement	Appartements
Appenzell	—
Aquarell	Aquarelle
Aquarium	Aquarien
Arabien	—
Arabisch	—
Arbeitsamt	Arbeitsämter
Arbeitsfeld	Arbeitsfelder
Arbeitsgebiet	Arbeitsgebiete
Arbeitsgericht	Arbeitsgerichte
Arbeitslager	Arbeitslager
Arbeitsleben	Arbeitsleben
Arbeitslosengeld	Arbeitslosengelder
Arbeitsministerium	Arbeitsministerien
Arbeitsprogramm	Arbeitsprogramme
Arbeitsrecht	Arbeitsrechte
Arbeitszeitmodell	Arbeitszeitmodelle
Arbeitszimmer	Arbeitszimmer
Archiv	Archive
Archivbild	Archivbilder
Areal	Areale
Arg	—
Argument	Argumente
Arizona	—
Arkansas	—
Armaturenbrett	Armaturenbretter
Armband	Armbänder
Armenhaus	Armenhäuser
Armenien	—
Armenviertel	Armenviertel
Armutszeugnis	Armutszeugnisse
Aroma	Aromas
Arrangement	Arrangements
Arrondissement	Arrondissements
Arschloch	Arschlöcher
Arsenal	Arsenale
Artefakt	Artefakte
Arzneimittel	Arzneimittel
Aschenputtel	—
Aserbaidschan	—
Asien	—
Aspirin	Aspirins
Assisi	—
Asthma	—
Asyl	Asyle
Asylbewerberheim	Asylbewerberheime
Asylrecht	Asylrechte
Asylverfahren	Asylverfahren
Atelier	Ateliers
Athen	—
Atlantis	—
Atoll	Atolle
Atom	Atome
Atomkraftwerk	Atomkraftwerke
Atomprogramm	Atomprogramme
Atrium	Atrien
Attentat	Attentate
Attest	Atteste
Attribut	Attribute
Auditorium	Auditorien
Aufenthaltsrecht	Aufenthaltsrechte
Aufgabengebiet	Aufgabengebiete
Aufgebot	Aufgebote
Aufkommen	Aufkommen
Aufräumen	Aufräumen
Aufsehen	Aufsehen
Aufsichtsgremium	Aufsichtsgremien
Aufsichtsratsmitglied	Aufsichtsratsmitglieder
Aufstiegsspiel	Aufstiegsspiele
Auftaktspiel	Auftaktspiele
Auftragsbuch	Auftragsbücher
Auftragsvolumen	Auftragsvolumen	Auftragsvolumina
Auge	Augen
Augenmerk	—
Augenzwinkern	—
Augsburg	—
Auktionshaus	Auktionshäuser
Aus	—
Ausbildungsjahr	Ausbildungsjahre
Ausbildungszentrum	Ausbildungszentren
Ausflugsziel	Ausflugsziele
Ausführen	Ausführen
Ausland	—
Auslaufmodell	Auslaufmodelle
Auslöschen	Auslöschen
Ausrücken	Ausrücken
Ausschussmitglied	Ausschussmitglieder
Aussehen	Aussehen
Aussterben	Aussterben
Austauschprogramm	Austauschprogramme
Australien	—
Austria	—
Auswahlverfahren	Auswahlverfahren
Ausweichmanöver	Ausweichmanöver
Auto	Autos
Autogramm	Autogramme
Autohaus	Autohäuser
Automobil	Automobile
Autonomiegebiet	Autonomiegebiete
Autoradio	Autoradios
Autorennen	Autorennen
Autowrack	Autowracks	Autowracke
Ave	Ave	Aves
Avignon	—
Baby	Babys
Babylon	—
Backhaus	Backhäuser
Bad	Bäder
Badezimmer	Badezimmer
Badminton	—
Bagdad	—
Bahngleis	Bahngleise
Bahnhofsviertel	Bahnhofsviertel
Bahrain	—
Bakterium	Bakterien
Baku	—
Bali	—
Ballett	Ballette
Ballhaus	Ballhäuser
Ballungsgebiet	Ballungsgebiete
Ballungszentrum	Ballungszentren
Baltikum	—
Band	Bänder
Bandmitglied	Bandmitglieder
Bangladesch	—
Bankgeheimnis	Bankgeheimnisse
Bankhaus	Bankhäuser
Banking	—
Bankkonto	Bankkonten	Bankkontos	Bankkonti
Banner	Banner
Barcelona	—
Bargeld	Bargelder
Barrel	Barrels
Basel	—
Baskenland	—
Bataillon	Bataillone
Bauamt	Bauämter
Baudenkmal	Baudenkmale	Baudenkmäler
Bauelement	Bauelemente
Bauernhaus	Bauernhäuser
Baugebiet	Baugebiete
Baugewerbe	—
Bauhaus	Bauhäuser
Baujahr	Baujahre
Bauland	—
Baumaterial	Baumaterialien
Bauprojekt	Bauprojekte
Baurecht	Baurechte
Baureferat	Baureferate
Bauunternehmen	Bauunternehmen
Bauvorhaben	Bauvorhaben
Bauwerk	Bauwerke
Bauwesen	—
Bayern	—
Becken	Becken
Bedenken	Bedenken
Bedürfnis	Bedürfnisse
Begehren	Begehren
Begräbnis	Begräbnisse
Beil	Beile
Beileid	—
Bein	Beine
Beirut	—
Beisammensein	—
Beisein	—
Beispiel	Beispiele
Beitrittsland	Beitrittsländer
Beiwerk	Beiwerke
Bekennerschreiben	Bekennerschreiben
Bekenntnis	Bekenntnisse
Beladen	Beladen
Belgien	—
Belgrad	—
Belieben	Belieben
Bellinzona	Bellinzonas
Belvedere	Belvederes
Bemühen	Bemühen
Benefiz	Benefize
Benefizkonzert	Benefizkonzerte
Benehmen	Benehmen
Benzin	Benzine
Benzol	Benzole
Beratungsangebot	Beratungsangebote
Beratungsunternehmen	Beratungsunternehmen
Bergdorf	Bergdörfer
Bergland	Bergländer
Bergsteigen	—
Bergwerk	Bergwerke
Berichtsjahr	Berichtsjahre
Berlin	—
Bern	—
Berufsbild	Berufsbilder
Berufsheer	Berufsheere
Berufsleben	Berufsleben
Berufsverbot	Berufsverbote
Berufungsgericht	Berufungsgerichte
Berufungsverfahren	Berufungsverfahren
Beruhigungsmittel	Beruhigungsmittel
Best	—
Bestechungsgeld	Bestechungsgelder
Besteck	Bestecke
Beta	Betas
Bethlehem	—
Betreuungsangebot	Betreuungsangebote
Betriebsergebnis	Betriebsergebnisse
Betriebsklima	—
Betriebssystem	Betriebssysteme
Bett	Betten
Betäubungsmittel	Betäubungsmittel
Beweismaterial	Beweismaterialien
Beweismittel	Beweismittel
Beweisstück	Beweisstücke
Bewerbungsgespräch	Bewerbungsgespräche
Bewusstsein	Bewusstseine
Bezirksamt	Bezirksämter
Bezirksgericht	Bezirksgerichte
Bezugsrecht	Bezugsrechte
Biedermeier	—
Bielefeld	—
Bier	Biere
Bierzelt	Bierzelte
Bike	Bikes
Bild	Bilder
Bilderbuch	Bilderbücher
Bildmaterial	Bildmaterialien
Bildnis	Bildnisse
Bildungsangebot	Bildungsangebote
Bildungsministerium	Bildungsministerien
Bildungssystem	Bildungssysteme
Bildungswesen	Bildungswesen
Bildungszentrum	Bildungszentren
Billard	Billarde	Billards
Billett	Billetts	Billette
Billiglohnland	Billiglohnländer
Bindeglied	Bindeglieder
Biogas	Biogase
Birma	—
Bistro	Bistros
Bistum	Bistümer
Blasorchester	Blasorchester
Blatt	Blätter
Blau	Blaus
Blaulicht	Blaulichter
Blech	Bleche
Bleiberecht	Bleiberechte
Blickfeld	Blickfelder
Blitzlicht	Blitzlichter
Blockheizkraftwerk	Blockheizkraftwerke
Blut	Blute
Blutbad	Blutbäder
Blutvergießen	—
Blümchen	Blümchen
Bobo	Bobos
Bolivien	—
Bollwerk	Bollwerke
Bologna	—
Bombardement	Bombardements
Bombenattentat	Bombenattentate
Bonmot	Bonmots
Bonn	—
Boot	Boote
Bordell	Bordelle
Borneo	—
Bosnien	—
Botswana	—
Boulevardblatt	Boulevardblätter
Bowling	—
Bozen	—
Brandenburg	—
Brasilien	—
Brauchtum	Brauchtümer
Braun	Brauns
Braunschweig	—
Brautpaar	Brautpaare
Brazzaville	—
Bregenz	—
Bremen	—
Brennelement	Brennelemente
Brennholz	Brennhölzer
Breslau	—
Brett	Bretter
Brettspiel	Brettspiele
Bridge	—
Britannien	—
Brot	Brote
Brummen	Brummen
Bruttoeinkommen	Bruttoeinkommen
Bruttoinlandsprodukt	Bruttoinlandsprodukte
Bruttosozialprodukt	Bruttosozialprodukte
Brötchen	Brötchen
Brüllen	Brüllen
Buch	Bücher
Budapest	—
Budget	Budgets
Budgetdefizit	Budgetdefizite
Buffet	Buffets
Bukarest	—
Bulgarien	—
Bulletin	Bulletins
Bundesamt	Bundesämter
Bundesarbeitsgericht	—
Bundesarbeitsministerium	Bundesarbeitsministerien
Bundesdenkmalamt	Bundesdenkmalämter
Bundesfinanzministerium	Bundesfinanzministerien
Bundesforschungsministerium	Bundesforschungsministerien
Bundesgebiet	Bundesgebiete
Bundesgericht	Bundesgerichte
Bundesgesetz	Bundesgesetze
Bundesgesundheitsministerium	—
Bundeshaus	Bundeshäuser
Bundesheer	Bundesheere
Bundesinnenministerium	Bundesinnenministerien
Bundesinstitut	Bundesinstitute
Bundesjustizministerium	Bundesjustizministerien
Bundeskabinett	Bundeskabinette
Bundeskanzleramt	Bundeskanzlerämter
Bundeskartellamt	—
Bundeskriminalamt	—
Bundesland	Bundesländer
Bundesligaspiel	Bundesligaspiele
Bundesministerium	Bundesministerien
Bundessozialgericht	Bundessozialgerichte
Bundestheater	Bundestheaters
Bundesumweltministerium	Bundesumweltministerien
Bundesverdienstkreuz	Bundesverdienstkreuze
Bundesverfassungsgericht	Bundesverfassungsgerichte
Bundesverkehrsministerium	—
Bundesverteidigungsministerium	Bundesverteidigungsministerien
Bundesverwaltungsgericht	Bundesverwaltungsgerichte
Bundeswirtschaftsministerium	Bundeswirtschaftsministerien
Bungee	—
Bureau	Bureaus	Bureaux
Burgenland	—
Burgund	—
Burma	—
Burundi	—
Business	—
Buxtehude	—
Bußgeld	Bußgelder
Bye	Byes
Byte	Byte	Bytes
Bündnis	Bündnisse
Bürgerrecht	Bürgerrechte
Büro	Büros
Cabrio	Cabrios
Cabriolet	Cabriolets
Cafe	Cafes
Café	Cafés
Cambridge	—
Camp	Camps
Canberra	—
Cannes	—
Cape	Capes
Capri	—
Cardiff	—
Carol	Carols
Cash	—
Casino	Casinos
Casting	Castings
Castle	Castles
Catering	Caterings
Cello	Cellos
Celsius	Celsius
Cembalo	Cembali	Cembalos
Championat	Championate
Chaos	—
Charakteristikum	Charakteristika
Charisma	Charismen	Charismata
Chemieunternehmen	Chemieunternehmen
Chicago	—
Chile	—
China	—
Chinesisch	—
Chlor	—
Cholesterin	Cholesterine
Christentum	Christentümer
Christkind	—
Chrom	—
Chromosom	Chromosomen
Chur	—
Coaching	Coachings
Cockpit	Cockpits
Colorado	—
Columbia	—
Comeback	Comebacks
Computernetz	Computernetze
Computerprogramm	Computerprogramme
Computerspiel	Computerspiele
Computersystem	Computersysteme
Connecticut	—
Containerschiff	Containerschiffe
Controlling	—
Copyright	Copyrights
Corpus	Corpora
Cottbus	—
Cover	Cover	Covers
Credo	Credos
Cuba	—
Curling	—
Dach	Dächer
Dachau	—
Dachgeschoss	Dachgeschosse
Daheim	—
Dakar	—
Damaskus	—
Damoklesschwert	Damoklesschwerter
Dancing	—
Dankeschön	Dankeschöns
Danzig	—
Darlehen	Darlehen
Darmstadt	—
Dasein	Daseine
Datennetz	Datennetze
Datum	Daten
Debakel	Debakel
Debüt	Debüts
Deck	Decks
Defizit	Defizite
Deka	Deka
Dekret	Dekrete
Delhi	—
Delikt	Delikte
Dementi	Dementis
Denkmal	Denkmäler
Departement	Departements	Departemente
Department	Departments
Depot	Depots
Derivat	Derivate
Desaster	Desaster
Design	Designs
Desinteresse	—
Dessau	—
Dessert	Desserts
Dessous	Dessous
Detail	Details
Deutsch	—
Deutschland	Deutschländer
Dezernat	Dezernate
Dezibel	—
Dia	Dias
Diagramm	Diagramme
Dickicht	Dickichte
Diebesgut	Diebesgüter
Dienstjahr	Dienstjahre
Dienstleistungsunternehmen	Dienstleistungsunternehmen
Dienstleistungszentrum	Dienstleistungszentren
Dienstrecht	Dienstrechte
Diktat	Diktate
Dilemma	Dilemmas
Ding	Dinge
Dinner	Dinners
Dioxin	Dioxine
Diplom	Diplome
Direktmandat	Direktmandate
Direktorium	Direktorien
Diskussionsforum	Diskussionsforen
Display	Displays
Disziplinarverfahren	Disziplinarverfahren
Dock	Docks
Dogma	Dogmen	Dogmata
Doha	—
Dokument	Dokumente
Dokumentationszentrum	Dokumentationszentren
Domizil	Domizile
Doping	—
Dopingmittel	Dopingmittel
Doppelzimmer	Doppelzimmer
Dorado	Dorados
Dorf	Dörfer
Dorffest	Dorffeste
Dorfzentrum	Dorfzentren
Dosenpfand	Dosenpfänder
Dossier	Dossiers
Double	Doubles
Drama	Dramen
Drehbuch	Drehbücher
Drehkreuz	Drehkreuze
Drehmoment	Drehmomente
Dreieck	Dreiecke
Dresden	—
Drittland	Drittländer
Drogenproblem	Drogenprobleme
Druckmittel	Druckmittel
Dröhnen	Dröhnen
Dubai	—
Dublin	—
Dubrovnik	—
Duell	Duelle
Duett	Duette
Duisburg	—
Dumping	Dumpings
Duo	Duos
Dur	—
Durcheinander	Durcheinander
Durchschnittsalter	Durchschnittsalter
Durchschnittseinkommen	Durchschnittseinkommen
Dutzend	Dutzende
Dynamit	—
Dänemark	—
Dänisch	—
Eck	Ecke	Ecken
Ecuador	—
Edelmetall	Edelmetalle
Eden	—
Edinburgh	—
Ego	Egos
Ehepaar	Ehepaare
Ehrenamt	Ehrenämter
Ehrenmitglied	Ehrenmitglieder
Ehrenwort	Ehrenwörter
Ehrenzeichen	Ehrenzeichen
Ei	Eier
Eichhorn	Eichhörner
Eichhörnchen	Eichhörnchen
Eigen	—
Eigenheim	Eigenheime
Eigeninteresse	Eigeninteressen
Eigenkapital	Eigenkapitalien	Eigenkapitale
Eigenleben	Eigenleben
Eigentor	Eigentore
Eigentum	Eigentume
Eigentumsrecht	Eigentumsrechte
Eiland	Eilande
Eilverfahren	Eilverfahren
Einatmen	Einatmen
Einbringen	Einbringen
Eindringen	Eindringen
Einfamilienhaus	Einfamilienhäuser
Einkaufen	Einkaufen
Einkaufszentrum	Einkaufszentren
Einkommen	Einkommen
Einlegen	Einlegen
Einmaleins	—
Einsatzfahrzeug	Einsatzfahrzeuge
Einsatzgebiet	Einsatzgebiete
Einsatzkommando	Einsatzkommandos
Einschreiben	Einschreiben
Eintreffen	Eintreffen
Eintrittsgeld	Eintrittsgelder
Einvernehmen	—
Einwanderungsgesetz	Einwanderungsgesetze
Einwanderungsland	Einwanderungsländer
Einzel	Einzel
Einzelschicksal	Einzelschicksale
Einzelteil	Einzelteile
Einzelzeitfahren	Einzelzeitfahren
Einzelzimmer	Einzelzimmer
Einzugsgebiet	Einzugsgebiete
Eis	—
Eisen	Eisen
Eisenach	—
Eisenerz	Eisenerze
Eishockey	Eishockeys
Eisstadion	Eisstadien
Eldorado	Eldorados
Element	Elemente
Elend	—
Elfenbein	Elfenbeine
Elterngeld	—
Elternhaus	Elternhäuser
Email	Emails
Embargo	Embargos
Emblem	Embleme	Emblemata
Emd	—
Emirat	Emirate
Ende	Enden
Endergebnis	Endergebnisse
Endlager	Endlager
Endprodukt	Endprodukte
Endspiel	Endspiele
Energieversorgungsunternehmen	Energieversorgungsunternehmen
Engagement	Engagements
Engelchen	Engelchen
Engineering	—
England	—
Englisch	—
Enkelkind	Enkelkinder
Ensemble	Ensembles
Entertainment	Entertainments
Entgegenkommen	Entgegenkommen
Entgelt	Entgelte
Entsetzen	Entsetzen
Entwicklungsland	Entwicklungsländer
Entwicklungsprogramm	Entwicklungsprogramme
Entwicklungsprojekt	Entwicklungsprojekte
Enzym	Enzyme
Epizentrum	Epizentren
Epos	Epen
Equipment	Equipments
Erbe	—
Erbarmen	Erbarmen
Erbgut	Erbgüter
Erbrechen	Erbrechen
Erdbeben	Erdbeben
Erdbebenopfer	Erdbebenopfer
Erdgas	Erdgase
Erdgeschoss	Erdgeschosse
Erdreich	—
Erdöl	Erdöle
Ereignis	Ereignisse
Erfassen	Erfassen
Erfolgserlebnis	Erfolgserlebnisse
Erfolgsgeheimnis	Erfolgsgeheimnisse
Erfolgsrezept	Erfolgsrezepte
Erfordernis	Erfordernisse
Erfurt	—
Ergebnis	Ergebnisse
Erholungsgebiet	Erholungsgebiete
Eritrea	—
Erlebnis	Erlebnisse
Erlebnisbad	Erlebnisbäder
Erlöschen	Erlöschen
Ermessen	Ermessen
Ermittlungsverfahren	Ermittlungsverfahren
Ernähren	Ernähren
Ersatzteil	Ersatzteile
Erscheinungsbild	Erscheinungsbilder
Erstaunen	Erstaunen
Ersuchen	Ersuchen
Erwerbsleben	Erwerbsleben
Erz	Erze
Erzbistum	Erzbistümer
Erzeugnis	Erzeugnisse
Erzgebirge	—
Erziehungsgeld	Erziehungsgelder
Essen	Essen
Establishment	Establishments
Estland	—
Etablissement	Etablissements
Etappenziel	Etappenziele
Ethernet	—
Ethos	—
Etikett	Etikette	Etiketten	Etiketts
Etwas	Etwas	Etwasse
Euroland	Euroländer
Europaparlament	—
Evangelium	Evangelien
Examen	Examen
Exekutivkomitee	Exekutivkomitees
Exempel	Exempel
Exemplar	Exemplare
Exil	Exile
Existenzminimum	Existenzminima
Experiment	Experimente
Exponat	Exponate
Extrem	Extreme
Fach	Fächer
Fachblatt	Fachblätter
Fachgebiet	Fachgebiete
Fachmagazin	Fachmagazine
Fachwerkhaus	Fachwerkhäuser
Fachwissen	—
Fagott	Fagotte
Fahrrad	Fahrräder
Fahrverbot	Fahrverbote
Fahrverhalten	Fahrverhalten
Fahrwasser	Fahrwasser
Fahrwerk	Fahrwerke
Fahrzeug	Fahrzeuge
Faible	Faibles
Faksimile	Faksimiles
Falschgeld	Falschgelder
Faltblatt	Faltblätter
Familiendrama	Familiendramen
Familienfest	Familienfeste
Familienleben	—
Familienministerium	Familienministerien
Familienmitglied	Familienmitglieder
Familienunternehmen	Familienunternehmen
Fass	Fässer
Fatum	Fata
Fazit	Fazits	Fazite
Federspiel	Federspiele
Federvieh	—
Feedback	Feedbacks
Fegefeuer	—
Fehlverhalten	—
Feigenblatt	Feigenblätter
Feindbild	Feindbilder
Feld	Felder
Fell	Felle
Fenster	Fenster
Ferienhaus	Ferienhäuser
Ferkel	Ferkel
Ferngespräch	Ferngespräche
Fernglas	Ferngläser
Fernrohr	Fernrohre
Fernsehbild	Fernsehbilder
Fernsehen	Fernsehen
Fernsehinterview	Fernsehinterviews
Fernsehprogramm	Fernsehprogramme
Fernsehspiel	Fernsehspiele
Fernsehstudio	Fernsehstudios
Fernsehteam	Fernsehteams
Fernweh	—
Fernziel	Fernziele
Fertighaus	Fertighäuser
Fest	Feste
Festival	Festivals
Festland	Festländer	Festlande
Festnetz	Festnetze
Festspiel	Festspiele
Festspielhaus	Festspielhäuser
Festzelt	Festzelte
Fett	Fette
Feuchtgebiet	Feuchtgebiete
Feuer	Feuer
Feuergefecht	Feuergefechte
Feuerwehrhaus	Feuerwehrhäuser
Feuerwerk	Feuerwerke
Feuerzeug	Feuerzeuge
Feuilleton	Feuilletons
Fiasko	Fiaskos
Fieber	Fieber
Filialnetz	Filialnetze
Filmfest	Filmfeste
Filmfestival	Filmfestivals
Filmgeschäft	Filmgeschäfte
Filmmaterial	Filmmaterialien
Filmmuseum	Filmmuseen
Filmprojekt	Filmprojekte
Filmstudio	Filmstudios
Filmteam	Filmteams
Filmtheater	Filmtheater
Finale	Finale	Finals	Finali
Finalspiel	Finalspiele
Finanzamt	Finanzämter
Finanzierungsmodell	Finanzierungsmodelle
Finanzinstitut	Finanzinstitute
Finanzministerium	Finanzministerien
Finanzproblem	Finanzprobleme
Finanzressort	Finanzressorts
Finanzsystem	Finanzsysteme
Fine	Fines
Finish	Finishs
Finnland	—
Fis	Fis
Fischerboot	Fischerboote
Fitnessstudio	Fitnessstudios
Fixing	Fixings
Flach	Flache
Flachdach	Flachdächer
Flachland	Flachländer
Flaggschiff	Flaggschiffe
Flandern	—
Flattern	Flattern
Fleisch	—
Flensburg	—
Florenz	—
Florett	Florette
Florida	—
Flugblatt	Flugblätter
Flugticket	Flugtickets
Flugverbot	Flugverbote
Flugzeug	Flugzeuge
Flussbett	Flussbetten	Flussbette
Flutlicht	Flutlichter
Flutopfer	Flutopfer
Fläschchen	Fläschchen
Flüchtlingslager	Flüchtlingslager
Fohlen	Fohlen
Folgejahr	Folgejahre
Format	Formate
Formular	Formulare
Forscherteam	Forscherteams
Forschungsergebnis	Forschungsergebnisse
Forschungsinstitut	Forschungsinstitute
Forschungsprogramm	Forschungsprogramme
Forschungsprojekt	Forschungsprojekte
Forschungszentrum	Forschungszentren
Forstamt	Forstämter
Fort	Forts
Forte	Fortes	Forti
Forum	Foren
Fossil	Fossilien
Foto	Fotos
Fotografieren	Fotografieren
Foul	Fouls
Foulspiel	Foulspiele
Foyer	Foyers
Fragezeichen	Fragezeichen
Fragment	Fragmente
Fraktionsmitglied	Fraktionsmitglieder
Frankreich	—
Französisch	—
Frauchen	Frauchen
Frauenbild	Frauenbilder
Frauenfeld	—
Frauenhaus	Frauenhäuser
Freibad	Freibäder
Freibier	Freibiere
Freiburg	—
Freihandelsabkommen	Freihandelsabkommen
Freiheitsrecht	Freiheitsrechte
Freiland	—
Freilichtmuseum	Freilichtmuseen
Freizeitangebot	Freizeitangebote
Freizeitzentrum	Freizeitzentren
Fremdenverkehrsamt	Fremdenverkehrsämter
Fremdverschulden	—
Fremdwort	Fremdwörter
Freundschaftsspiel	Freundschaftsspiele
Friaul	—
Friedensabkommen	Friedensabkommen
Friedrichshafen	—
Frühstück	Frühstücke
Fundament	Fundamente
Funkbild	Funkbilder
Funkgerät	Funkgeräte
Funkhaus	Funkhäuser
Futter	Futter
Futtermittel	Futtermittel
Futur	Future
Gal	Gals
Gamma	Gammas
Gartenhaus	Gartenhäuser
Gas	Gase
Gaspedal	Gaspedale
Gastgewerbe	Gastgewerbe
Gasthaus	Gasthäuser
Gastland	Gastländer
Gastspiel	Gastspiele
Gaswerk	Gaswerke
Gatt	Gatten	Gatts
Gebaren	—
Gebein	Gebeine
Geberland	Geberländer
Gebet	Gebete
Gebiet	Gebiete
Gebilde	Gebilde
Gebirge	Gebirge
Gebiss	Gebisse
Gebot	Gebote
Gebrechen	Gebrechen
Gebräu	Gebräus
Geburtsdatum	Geburtsdaten
Geburtshaus	Geburtshäuser
Geburtstagsgeschenk	Geburtstagsgeschenke
Geburtstagskind	Geburtstagskinder
Gebäck	Gebäcke
Gebäude	Gebäude
Gebüsch	Gebüsche
Gedankengut	—
Gedankenspiel	Gedankenspiele
Gedenken	Gedenken
Gedicht	Gedichte
Gedränge	Gedränge
Gedächtnis	Gedächtnisse
Gedärm	Gedärme
Gefangenenlager	Gefangenenlager
Gefecht	Gefechte
Gefilde	Gefilde
Geflecht	Geflechte
Gefolge	Gefolge
Gefängnis	Gefängnisse
Gefäß	Gefäße
Gefühl	Gefühle
Gegenargument	Gegenargumente
Gegengewicht	Gegengewichte
Gegenmittel	Gegenmittel
Gegenteil	Gegenteile
Gegentor	Gegentore
Gehabe	—
Gehege	Gehege
Geheimnis	Geheimnisse
Gehirn	Gehirne
Geiseldrama	Geiseldramen
Gel	Gele	Gels
Gelaber	—
Gelb	Gelbs
Geld	Gelder
Geldinstitut	Geldinstitute
Geleise	Geleise
Geleit	Geleite
Gelenk	Gelenke
Gelingen	Gelingen
Gelsenkirchen	—
Gelächter	Gelächter
Gelände	Gelände
Geländer	Geländer
Gelübde	Gelübde
Gemeindeamt	Gemeindeämter
Gemeindehaus	Gemeindehäuser
Gemeindemitglied	Gemeindemitglieder
Gemeindezentrum	Gemeindezentren
Gemeinschaftsprojekt	Gemeinschaftsprojekte
Gemeinschaftsunternehmen	Gemeinschaftsunternehmen
Gemeinwesen	—
Gemeinwohl	—
Gemetzel	Gemetzel
Gemisch	Gemische
Gemüse	Gemüse
Gemüt	Gemüter
Gen	Gene
Genehmigungsverfahren	Genehmigungsverfahren
Generalkonsulat	Generalkonsulate
Genf	—
Genick	Genicke
Genie	Genies
Genitale	Genitalien
Genom	Genome
Genre	Genres
Georgia	—
Georgien	—
Gerangel	—
Gerede	—
Gericht	Gerichte
Gerichtsurteil	Gerichtsurteile
Gerichtsverfahren	Gerichtsverfahren
Geräusch	Geräusche
Gerüst	Gerüste
Gesamtbild	Gesamtbilder
Gesamtergebnis	Gesamtergebnisse
Gesamtgewicht	Gesamtgewichte
Gesamtjahr	Gesamtjahre
Gesamtklassement	Gesamtklassements
Gesamtkonzept	Gesamtkonzepte
Gesamtkunstwerk	Gesamtkunstwerke
Gesamtpaket	Gesamtpakete
Gesamtvolumen	Gesamtvolumen	Gesamtvolumina
Gesamtwerk	Gesamtwerke
Geschehen	Geschehen
Geschehnis	Geschehnisse
Geschenk	Geschenke
Geschichtsbuch	Geschichtsbücher
Geschick	Geschicke
Geschirr	Geschirre
Geschlecht	Geschlechter
Geschoss	Geschosse
Geschrei	Geschreis
Geschwister	Geschwister
Geschworenengericht	Geschworenengerichte
Geschäft	Geschäfte
Geschöpf	Geschöpfe
Geschütz	Geschütze
Gesellschaftsspiel	Gesellschaftsspiele
Gesetz	Gesetze
Gesetzbuch	Gesetzbücher
Gesetzgebungsverfahren	Gesetzgebungsverfahren
Gesicht	Gesichter
Gespann	Gespanne
Gespenst	Gespenster
Gespräch	Gespräche
Gespött	—
Gespür	—
Gestein	Gesteine
Gestell	Gestelle
Geständnis	Geständnisse
Gesuch	Gesuche
Gesundheitsamt	Gesundheitsämter
Gesundheitsministerium	Gesundheitsministerien
Gesundheitsrisiko	Gesundheitsrisiken	Gesundheitsrisikos	Gesundheitsrisken
Gesundheitssystem	Gesundheitssysteme
Gesundheitswesen	—
Getreide	Getreide
Getriebe	Getriebe
Getto	Gettos	Getti
Getue	—
Gewaltverbrechen	Gewaltverbrechen
Gewand	Gewänder
Gewebe	Gewebe
Gewehr	Gewehre
Gewerbe	Gewerbe
Gewerbegebiet	Gewerbegebiete
Gewerkschaftsmitglied	Gewerkschaftsmitglieder
Gewicht	Gewichte
Gewinnspiel	Gewinnspiele
Gewirr	—
Gewissen	Gewissen
Gewitter	Gewitter
Gewächshaus	Gewächshäuser
Gewässer	Gewässer
Gewölbe	Gewölbe
Gezerre	—
Ghana	—
Gibraltar	—
Gift	Gifte
Giftgas	Giftgase
Gigabyte	GigabytedieGigabytes
Gipfeltreffen	Gipfeltreffen
Girl	Girls
Girokonto	Girokonten	Girokontos	Girokonti
Gitter	Gitter
Glanzlicht	Glanzlichter
Glarus	—
Glas	Gläser
Glasgow	—
Glashaus	Glashäuser
Glatteis	—
Glaubensbekenntnis	Glaubensbekenntnisse
Gleichgewicht	Gleichgewichte
Gleichnis	Gleichnisse
Gleis	Gleise
Gleiten	Gleiten
Glied	Glieder
Gläschen	Gläschen
Glöckchen	Glöckchen
Glück	Glücke
Glücksspiel	Glücksspiele
Glühwürmchen	Glühwürmchen
Goal	Goals
Gold	—
Goldstück	Goldstücke
Google	—
Goslar	—
Gotteshaus	Gotteshäuser
Grab	Gräber
Grabmal	Grabmale	Grabmäler
Gramm	Gramme
Gras	Gräser
Grau	Graus
Grauen	Grauen
Gray	Gray
Graz	—
Greifswald	—
Gremium	Gremien
Grenzgebiet	Grenzgebiete
Grenzland	Grenzländer
Griechenland	—
Griechisch	—
Grillen	Grillen
Grillfest	Grillfeste
Großbritannien	—
Grundbuch	Grundbücher
Grundgesetz	Grundgesetze
Grundkapital	—
Grundnahrungsmittel	Grundnahrungsmittel
Grundprinzip	Grundprinzipien	Grundprinzipe
Grundproblem	Grundprobleme
Grundrecht	Grundrechte
Grundsatzprogramm	Grundsatzprogramme
Grundwasser	Grundwasser	Grundwässer
Grunzen	Grunzen
Gruppenspiel	Gruppenspiele
Grübchen	Grübchen
Grün	Grüns
Grünzeug	—
Gut	Güter
Gutachten	Gutachten
Guthaben	Guthaben
Gymnasium	Gymnasien
Gähnen	Gähnen
Gänseblümchen	Gänseblümchen
Gästehaus	Gästehäuser
Gästezimmer	Gästezimmer
Haar	Haare
Hackfleisch	Hackfleische
Hafenbecken	Hafenbecken
Haifa	—
Haiti	—
Hakenkreuz	Hakenkreuze
Halbfinale	Halbfinale
Halbjahr	Halbjahre
Halleluja	Hallelujas
Hallenbad	Hallenbäder
Hallenturnier	Hallenturniere
Hallo	Hallos
Halloween	Halloweens
Halsband	Halsbänder
Halteverbot	Halteverbote
Hamburg	—
Hameln	—
Handbuch	Handbücher
Handelsabkommen	Handelsabkommen
Handelshaus	Handelshäuser
Handelsregister	Handelsregister
Handelssystem	Handelssysteme
Handelsunternehmen	Handelsunternehmen
Handelsvolumen	Handelsvolumen	Handelsvolumina
Handgelenk	Handgelenke
Handgemenge	Handgemenge
Handicap	Handicaps
Handling	—
Handtuch	Handtücher
Handumdrehen	—
Handwerk	Handwerke
Handy	Handys
Hannover	—
Hanoi	—
Happening	Happenings
Harare	—
Harmonium	Harmonien	Harmoniums
Hasch	—
Haupt	Häupter
Hauptanliegen	Hauptanliegen
Hauptargument	Hauptargumente
Hauptaugenmerk	—
Hauptproblem	Hauptprobleme
Hauptquartier	Hauptquartiere
Hauptthema	Hauptthemata	Hauptthemen
Hauptwerk	Hauptwerke
Hauptziel	Hauptziele
Haus	Häuser
Haushaltsdefizit	Haushaltsdefizite
Haushaltsjahr	Haushaltsjahre
Haushaltsloch	Haushaltslöcher
Hausmädchen	Hausmädchen
Haustier	Haustiere
Hausverbot	Hausverbote
Hawaii	—
Hearing	Hearings
Hebräisch	—
Heck	Hecke
Heer	Heere
Heft	Hefte
Heidelberg	—
Heil	—
Heilbad	Heilbäder
Heiligtum	Heiligtümer
Heilmittel	Heilmittel
Heim	Heime
Heimatdorf	Heimatdörfer
Heimatland	Heimatländer
Heimatmuseum	Heimatmuseen
Heimrecht	Heimrechte
Heimspiel	Heimspiele
Heimweh	—
Heizkraftwerk	Heizkraftwerke
Helium	—
Helsinki	—
Hemd	Hemden
Hemmnis	Hemmnisse
Herkommen	Herkommen
Herkunftsland	Herkunftsländer
Herrchen	Herrchen
Herrenhaus	Herrenhäuser
Hertz	—
Herz	Herzen
Herzblatt	Herzblätter
Herzblut	—
Herzogtum	Herzogtümer
Herzversagen	—
Hessen	—
Heu	—
Hilfsangebot	Hilfsangebote
Hilfsgut	Hilfsgüter
Hilfsmittel	Hilfsmittel
Hilfspaket	Hilfspakete
Hilfsprogramm	Hilfsprogramme
Hilfsprojekt	Hilfsprojekte
Hilfswerk	Hilfswerke
Himmelreich	—
Hindernis	Hindernisse
Hinterhaus	Hinterhäuser
Hinterland	—
Hinterrad	Hinterräder
Hinterteil	Hinterteile
Hintertreffen	Hintertreffen
Hinterzimmer	Hinterzimmer
Hinweisschild	Hinweisschilder
Hirn	Hirne
Hobby	Hobbys
Hoch	Hochs
Hochbauamt	Hochbauämter
Hochgebirge	Hochgebirge
Hochhaus	Hochhäuser
Hochland	Hochländer	Hochlande
Hochschulgesetz	Hochschulgesetze
Hochwasser	Hochwasser
Hochzeitsgeschenk	Hochzeitsgeschenke
Hockey	Hockeys
Holland	—
Hollywood	—
Holländisch	—
Holstein	—
Holz	Hölzer
Holzhaus	Holzhäuser
Honduras	—
Hongkong	—
Honorar	Honorare
Hormon	Hormone
Horn	Hörner
Horoskop	Horoskope
Hospital	Hospitale
Hospiz	Hospize
Hotel	Hotels
Hotelzimmer	Hotelzimmer
Huhn	Hühner
Hundert	Hundert	Hunderte
Hunderttausend	—
Hurra	Hurras
Hähnchen	Hähnchen
Häufchen	Häufchen
Hühnchen	Hühnchen
Ibiza	—
Ich	Ich	Ichs
Ideal	Ideale
Idiom	Idiome
Idol	Idole
Idyll	Idylle
Illinois	—
Image	Images
Imitieren	Imitieren
Immunsystem	Immunsysteme
Imperium	Imperien
Implantat	Implantate
Importverbot	Importverbote
Indiana	—
Indien	—
Individuum	Individuen
Indiz	Indizien
Indonesien	—
Industriegebiet	Industriegebiete
Industrieland	Industrieländer
Industrieunternehmen	Industrieunternehmen
Inferno	Infernos
Informationsmaterial	Informationsmaterialen
Informationssystem	Informationssysteme
Informationszentrum	Informationszentren
Infrarot	—
Inkrafttreten	—
Inland	—
Innenleben	—
Innenministerium	Innenministerien
Innsbruck	—
Innviertel	Innviertel
Insekt	Insekten
Inserat	Inserate
Insolvenzverfahren	Insolvenzverfahren
Institut	Institute
Instrument	Instrumente
Instrumentarium	Instrumentarien
Insulin	—
Interesse	Interessen
Interface	Interfaces
Interieur	Interieurs	Interieure
Interim	Interims
Intermezzo	Intermezzi	Intermezzos
Internat	Internate
Internet	—
Intervall	Intervalle
Interview	Interviews
Intranet	Intranets
Inventar	Inventare
Investitionsprogramm	Investitionsprogramme
Investitionsvolumen	Investitionsvolumen	Investitionsvolumina
Investment	Investments
Investmentbanking	—
Ion	Ionen
Irland	—
Ischl	—
Islamabad	—
Island	—
Israel	—
Istanbul	—
Italien	—
Italienisch	—
Jackett	Jacketts
Jagdschloss	Jagdschlösser
Jahr	Jahre
Jahrbuch	Jahrbücher
Jahresbudget	Jahresbudgets
Jahreseinkommen	Jahreseinkommen
Jahresende	Jahresenden
Jahresergebnis	Jahresergebnisse
Jahresgehalt	Jahresgehälter
Jahresprogramm	Jahresprogramme
Jahrhundert	Jahrhunderte
Jahrtausend	Jahrtausende
Jahrzehnt	Jahrzehnten
Jakarta	—
Jamaika	Jamaikas
Japan	—
Japanisch	—
Jaulen	Jaulen
Jawort	Jaworte
Jena	—
Jenseits	—
Jetzt	—
Joch	Joche
Jogging	—
Johannesburg	—
Jordanien	—
Jubiläum	Jubiläen
Judentum	Judentümer
Jugendamt	Jugendämter
Jugendbuch	Jugendbücher
Jugendhaus	Jugendhäuser
Jugendheim	Jugendheime
Jugendorchester	Jugendorchester
Jugendtheater	Jugendtheaters
Jugendzentrum	Jugendzentren
Jugoslawien	—
Jungtier	Jungtiere
Justizministerium	Justizministerien
Kabarett	Kabarette	Kabaretts
Kabelnetz	Kabelnetze
Kabinett	Kabinette
Kabinettsmitglied	Kabinettsmitglieder
Kabul	—
Kaffeehaus	Kaffeehäuser
Kairo	—
Kaiserreich	Kaiserreiche
Kaiserslautern	—
Kalb	Kälber
Kaleidoskop	Kaleidoskope
Kalenderjahr	Kalenderjahre
Kaliber	Kaliber
Kalifornien	—
Kaliningrad	—
Kalzium	—
Kambodscha	—
Kamel	Kamele
Kamerateam	Kamerateams
Kamerun	—
Kammergericht	Kammergerichte
Kammerorchester	Kammerorchester
Kammerspiel	Kammerspiele
Kampfflugzeug	Kampfflugzeuge
Kanada	—
Kaninchen	Kaninchen
Kanu	Kanus
Kanzleramt	Kanzlerämter
Kap	Kaps
Kapital	Kapitale
Kapitel	Kapitel
Kappel	Kappeln
Kapstadt	—
Kar	Kare
Karaoke	—
Karate	—
Karenzgeld	Karenzgelder
Karlsruhe	—
Karo	Karos
Karriereende	Karriereenden
Kartell	Kartelle
Kartellamt	Kartellämter
Kartellrecht	—
Kartenspiel	Kartenspiele
Karussell	Karussells
Kasachstan	—
Kasino	Kasinos
Kassel	—
Katalonien	—
Katar	—
Katastrophengebiet	Katastrophengebiete
Kaufangebot	Kaufangebote
Kaufhaus	Kaufhäuser
Kavaliersdelikt	Kavaliersdelikte
Kenia	—
Kennwort	Kennwörter
Kennzeichen	Kennzeichen
Kentucky	—
Kernkraftwerk	Kernkraftwerke
Kernland	Kernländer
Kerosin	—
Kerzenlicht	Kerzenlichter
Keyboard	Keyboards
Khartum	—
Kid	Kids
Kiew	—
Kigali	—
Kilogramm	Kilogramm
Kilowatt	Kilowatt
Kind	Kinder
Kinderbuch	Kinderbücher
Kinderdorf	Kinderdörfer
Kinderfest	Kinderfeste
Kindergartenkind	Kindergartenkinder
Kindergeld	Kindergelder
Kinderhaus	Kinderhäuser
Kinderheim	Kinderheime
Kinderlied	Kinderlieder
Kinderprogramm	Kinderprogramme
Kinderspiel	Kinderspiele
Kindertheater	Kindertheater
Kinderzimmer	Kinderzimmer
Kindesalter	—
Kingston	—
Kinn	Kinne
Kino	Kinos
Kinocenter	Kinocenters
Kinshasa	—
Kirchdorf	Kirchdörfer
Kirchenasyl	Kirchenasyle
Kirchenschiff	Kirchenschiffe
Kirchgemeindehaus	Kirchgemeindehäuser
Kissen	Kissen
Kitz	Kitze
Klangbild	Klangbilder
Klappern	Klappern
Klassenzimmer	Klassenzimmer
Klavier	Klaviere
Klavierkonzert	Klavierkonzerte
Klebeband	Klebebänder
Kleid	Kleider
Klein	—
Kleinfeld	Kleinfelder
Kleingeld	—
Kleinkind	Kleinkinder
Kleinod	Kleinode	Kleinodien
Kleintier	Kleintiere
Klima	Klimas
Klinikum	Klinika	Kliniken
Klischee	Klischees
Klo	Klos
Klopapier	Klopapiere
Kloster	Klöster
Klubhaus	Klubhäuser
Knie	Knie
Knochenmark	—
Knöpfchen	Knöpfchen
Koblenz	—
Kochbuch	Kochbücher
Kochen	Kochen
Kohlekraftwerk	Kohlekraftwerke
Kohlendioxid	Kohlendioxide
Kohlenmonoxid	Kohlenmonoxide
Kokain	—
Kollegium	Kollegien
Kollektiv	Kollektive
Kolloquium	Kolloquien
Kolumbien	—
Koma	Komas
Kombinat	Kombinate
Komitee	Komitees
Komma	Kommas	Kommata
Kommando	Kommandos
Kommissariat	Kommissariate
Kommissionsmitglied	Kommissionsmitglieder
Kommunikationsmittel	Kommunikationsmittel
Kommunikationssystem	Kommunikationssysteme
Kommunique	Kommuniques
Kompendium	Kompendien
Kompetenzzentrum	Kompetenzzentren
Kompliment	Komplimente
Konglomerat	Konglomerate
Kongresshaus	Kongresshäuser
Kongresszentrum	Kongresszentren
Konjunkturprogramm	Konjunkturprogramme
Konkursverfahren	Konkursverfahren
Konservatorium	Konservatorien
Konsortium	Konsortien
Konstantinopel	—
Konstrukt	Konstrukte
Konsulat	Konsulate
Konsumgut	Konsumgüter
Konterfei	Konterfeis	Konterfeie
Konto	Kontos
Kontra	Kontras
Kontrastprogramm	Kontrastprogramme
Kontrollamt	Kontrollämter
Kontrollgremium	Kontrollgremien
Kontrollsystem	Kontrollsysteme
Konvergenzkriterium	Konvergenzkriterien
Konzentrationslager	Konzentrationslager
Konzept	Konzepte
Konzernergebnis	Konzernergebnisse
Konzert	Konzerte
Konzerthaus	Konzerthäuser
Konzertprogramm	Konzertprogramme
Konzil	Konzile	Konzilien
Kopenhagen	—
Kopfgeld	Kopfgelder
Kopfsteinpflaster	Kopfsteinpflaster
Kopftuch	Kopftücher
Kopfweh	—
Kopfzerbrechen	—
Korea	Korea	Koreas
Korn	Körner
Korps	Korps
Korsett	Korsetts
Kosmetikum	Kosmetika
Kostüm	Kostüme
Krachen	Krachen
Kraftfahrzeug	Kraftfahrzeuge
Kraftwerk	Kraftwerke
Krakau	—
Krankenbett	Krankenbetten
Krankengeld	Krankengelder
Krankenhaus	Krankenhäuser
Krankheitsbild	Krankheitsbilder
Kraushaar	Kraushaare
Kraut	Kräuter
Krebsleiden	Krebsleiden
Kreditinstitut	Kreditinstitute
Krefeld	—
Kreischen	Kreischen
Kreisgebiet	Kreisgebiete
Kreiskrankenhaus	Kreiskrankenhäuser
Kreisverwaltungsreferat	Kreisverwaltungsreferate
Krematorium	Krematorien
Kreta	—
Kreuz	Kreuze
Kreuzfahrtschiff	Kreuzfahrtschiffe
Kreuzfeuer	Kreuzfeuer
Kreuzworträtsel	Kreuzworträtsel
Kriegsende	Kriegsenden
Kriegsgebiet	Kriegsgebiete
Kriegsjahr	Kriegsjahre
Kriegsopfer	Kriegsopfer
Kriegsrecht	—
Kriegsschiff	Kriegsschiffe
Kriegsverbrechen	Kriegsverbrechen
Kriegsverbrechertribunal	Kriegsverbrechertribunale
Krisengebiet	Krisengebiete
Krisenmanagement	Krisenmanagements
Kriterium	Kriterien
Kroatien	—
Krokodil	Krokodile
Kruzifix	Kruzifixe
Kuba	—
Kulturamt	Kulturämter
Kulturangebot	Kulturangebote
Kulturdenkmal	Kulturdenkmale	Kulturdenkmäler
Kulturerbe	—
Kulturgut	Kulturgüter
Kulturhaus	Kulturhäuser
Kulturinstitut	Kulturinstitute
Kulturleben	—
Kulturministerium	Kulturministerien
Kulturprogramm	Kulturprogramme
Kulturreferat	Kulturreferate
Kulturzentrum	Kulturzentren
Kultusministerium	Kultusministerien
Kunsthandwerk	Kunsthandwerke
Kunstmuseum	Kunstmuseen
Kunstobjekt	Kunstobjekte
Kunstprojekt	Kunstprojekte
Kunststück	Kunststücke
Kunstwerk	Kunstwerke
Kupfer	Kupfer
Kuratorium	Kuratorien
Kurdistan	—
Kurhaus	Kurhäuser
Kuriosum	Kuriosa
Kursbuch	Kursbücher
Kursniveau	Kursniveaus
Kursziel	Kursziele
Kurzprogramm	Kurzprogramme
Kuscheltier	Kuscheltiere
Kuvert	Kuverts
Kuwait	—
Küken	Küken
Lab	Labe
Label	Labels
Labor	Labors
Laboratorium	Laboratorien
Labyrinth	Labyrinthe
Ladenschlussgesetz	Ladenschlussgesetze
Lager	Lager
Lagerfeuer	Lagerfeuer
Lagerhaus	Lagerhäuser
Laken	Laken
Lamento	Lamentos	Lamenti
Lamm	Lämmer
Lampenfieber	—
Land	Länder
Landesamt	Landesämter
Landesgericht	Landesgerichte
Landesgesetz	Landesgesetze
Landeskriminalamt	Landeskriminalämter
Landesmuseum	Landesmuseen
Landesparlament	Landesparlamente
Landesstudio	Landesstudios
Landestheater	Landestheaters
Landgericht	Landgerichte
Landhaus	Landhäuser
Landratsamt	Landratsämter
Landschaftsbild	Landschaftsbilder
Landschaftsschutzgebiet	Landschaftsschutzgebiete
Landwirtschaftsministerium	Landwirtschaftsministerien
Laos	—
Latein	—
Lateinamerika	Lateinamerikas
Laub	—
Laufwerk	Laufwerke
Layout	Layouts
Lazarett	Lazarette
Learning	—
Leasing	—
Leben	Leben
Lebensalter	Lebensalter
Lebensende	Lebensenden
Lebensjahr	Lebensjahre
Lebensmittel	Lebensmittel
Lebenswerk	Lebenswerke
Lebenszeichen	Lebenszeichen
Lebewesen	Lebewesen
Leck	Lecks
Leder	Leder
Lehen	Lehen
Lehramt	Lehrämter
Lehrbuch	Lehrbücher
Lehrgeld	Lehrgelder
Lehrjahr	Lehrjahre
Leibchen	Leibchen
Leichenschauhaus	Leichenschauhäuser
Leichtgewicht	Leichtgewichte
Leid	—
Leidwesen	—
Leinen	Leinen
Leipzig	—
Leistungszentrum	Leistungszentren
Leitbild	Leitbilder
Leitmotiv	Leitmotive
Leningrad	—
Lenkrad	Lenkräder
Lesebuch	Lesebücher
Leslie	Leslies
Let	Lets
Lettland	—
Leugnen	Leugnen
Lexikon	Lexika	Lexiken
Liberia	—
Libretto	Librettos	Libretti
Libyen	—
Licht	Lichter
Lichtbild	Lichtbilder
Lichtjahr	Lichtjahre
Lichtspiel	Lichtspiele
Lid	Lider
Liebesleben	Liebesleben
Liebeslied	Liebeslieder
Liebespaar	Liebespaare
Lieblingsthema	Lieblingsthemen	Lieblingsthemata
Liechtenstein	—
Lied	Lieder
Liedgut	—
Lima	—
Limburg	—
Limit	Limits
Linux	—
Linz	—
Lippenbekenntnis	Lippenbekenntnisse
Lissabon	—
Litauen	—
Literaturhaus	Literaturhäuser
Liverpool	—
Loblied	Loblieder
Locarno	—
Loch	Löcher
Logbuch	Logbücher
Lohnniveau	Lohnniveaus
Lokal	Lokale
Lokalderby	Lokalderbys
London	—
Los	Lose
Lothringen	—
Lotto	Lottos
Louisiana	—
Luder	Luder
Luftgewehr	Luftgewehre
Luftschiff	Luftschiffe
Luftschloss	Luftschlösser
Lugano	Luganos
Lustspiel	Lustspiele
Lux	Lux
Luxor	—
Luxushotel	Luxushotels
Luzern	—
Lyon	—
Lächeln	Lächeln
Lämmchen	Lämmchen
Mach	Mach
Machtwort	Machtworte
Machtzentrum	Machtzentren
Machwerk	Machwerke
Madagaskar	—
Magazin	Magazine
Magdeburg	—
Magnesium	—
Magnetfeld	Magnetfelder
Mahl	Mahle
Mahnmal	Mahnmale	Mahnmäler
Mailand	—
Makedonien	—
Mal	Male
Malaysia	—
Malheur	Malheurs	Malheure
Mali	—
Mallorca	—
Malta	—
Malz	—
Mammut	Mammute	Mammuts
Management	Managements
Managua	—
Mandat	Mandate
Mandl	Mandl	Mandln
Manhattan	—
Manifest	Manifeste
Manila	—
Manko	Mankos
Manuskript	Manuskripte
Manöver	Manöver
Marburg	—
Marihuana	—
Markenzeichen	Markenzeichen
Marketing	—
Marktforschungsinstitut	Marktforschungsinstitute
Marktsegment	Marktsegmente
Marokko	—
Marseille	—
Martini	—
Martyrium	Martyrien
Maryland	—
Maschinengewehr	Maschinengewehre
Maskottchen	Maskottchen
Massachusetts	—
Massaker	Massaker
Massenblatt	Massenblätter
Massengrab	Massengräber
Massenmedium	Massenmedien
Massiv	Massive
Material	Materialien
Matt	Matts
Mauerwerk	Mauerwerke
Maul	Mäuler
Mausoleum	Mausoleen
Maximum	Maxima
Maxwell	Maxwells
Mecklenburg	—
Medienhaus	Medienhäuser
Medienunternehmen	Medienunternehmen
Medienzentrum	Medienzentren
Medikament	Medikamente
Medizinstudium	—
Meer	Meere
Meerschweinchen	Meerschweinchen
Meerwasser	Meerwasser	Meerwässer
Meeting	Meetings
Megabit	Megabits
Megabyte	MegabytedieMegabytes
Megahertz	—
Megawatt	Megawatt
Mehl	Mehle
Mehr	—
Mehrfamilienhaus	Mehrfamilienhäuser
Mehrheitswahlrecht	Mehrheitswahlrechte
Meinungsforschungsinstitut	Meinungsforschungsinstitute
Meisterschaftsspiel	Meisterschaftsspiele
Meisterstück	Meisterstücke
Meisterwerk	Meisterwerke
Melbourne	—
Melodram	Melodramen
Memorandum	Memoranda	Memoranden
Memory	Memorys
Menschenbild	Menschenbilder
Menschenleben	Menschenleben
Menschenrecht	Menschenrechte
Menü	Menüs
Meran	—
Merchandising	—
Merkblatt	Merkblätter
Merkmal	Merkmale
Metall	Metalle
Methadon	—
Methan	—
Metier	Metiers
Mexiko	Mexikos
Miami	—
Mietrecht	Mietrechte
Mietshaus	Mietshäuser
Mikrofon	Mikrofone
Mikrogramm	Mikrogramme
Mikroskop	Mikroskope
Milchprodukt	Milchprodukte
Milieu	Milieus
Millennium	Millennien
Milligramm	Milligramm
Mineral	Minerale	Mineralien
Mineralwasser	Mineralwasser	Mineralwässer
Minimum	Minima
Ministeramt	Ministerämter
Ministerium	Ministerien
Minnesota	—
Minsk	—
Minus	Minusse
Missfallen	—
Missgeschick	Missgeschicke
Missmanagement	—
Misstrauen	Misstrauen
Misstrauensvotum	Misstrauensvoten	Misstrauensvota
Missverständnis	Missverständnisse
Mitbringsel	Mitbringsel
Mitglied	Mitglieder
Mitgliedsland	Mitgliedsländer	Mitgliedslande
Mitleid	—
Mitspracherecht	Mitspracherechte
Mittagessen	Mittagessen
Mittel	Mittel
Mittelalter	—
Mittelamerika	Mittelamerikas
Mitteleuropa	—
Mittelfeld	Mittelfelder
Mittelgebirge	Mittelgebirge
Mittelmeer	—
Mixed	Mixed	Mixeds
Mobbing	—
Mobile	Mobiles
Mobilfunknetz	Mobilfunknetze
Mobiliar	Mobiliare
Mobiltelefon	Mobiltelefone
Modehaus	Modehäuser
Modell	Modelle
Modellprojekt	Modellprojekte
Modeln	Modeln
Mofa	Mofas
Mol	—
Molekül	Moleküle
Monatsende	Monatsenden
Monatsgehalt	Monatsgehälter
Monopol	Monopole
Monopoly	—
Monster	Monster
Monstrum	Monstren	Monstra
Montana	—
Montenegro	—
Montreal	—
Montreux	—
Monument	Monumente
Moor	Moore	Möser
Moos	Moose
Moped	Mopeds
Moratorium	Moratorien
Morddezernat	Morddezernate
Mordopfer	Mordopfer
Morgengrauen	Morgengrauen
Mosaik	Mosaiken	Mosaike
Moskau	—
Motel	Motels
Motiv	Motive
Moto	Motos
Motorboot	Motorboote
Motorrad	Motorräder
Motto	Mottos
Mountainbike	Mountainbikes
Multimedia	—
Multitalent	Multitalente
Museum	Museen
Musical	Musicals
Musikfest	Musikfeste
Musikinstrument	Musikinstrumente
Musikleben	—
Musiktheater	Musiktheater
Muster	Muster
Musterbeispiel	Musterbeispiele
Mutterland	Mutterländer
My	Mys
Mysterium	Mysterien
Mädchen	Mädchen
Mädel	Mädel
Männchen	Männchen
Mäuschen	Mäuschen
Möbel	Möbel	Möbeln
Münztelefon	Münztelefone
Müsli	Müslis
Mütterchen	Mütterchen
Nachbarhaus	Nachbarhäuser
Nachbarland	Nachbarländer
Nachholspiel	Nachholspiele
Nachkriegsjahr	Nachkriegsjahre
Nachrichtenmagazin	Nachrichtenmagazine
Nachschlagewerk	Nachschlagewerke
Nachspiel	Nachspiele
Nachtessen	Nachtessen
Nachthemd	Nachthemden
Nachtleben	—
Nachwort	Nachworte
Nachwuchstalent	Nachwuchstalente
Naherholungsgebiet	Naherholungsgebiete
Nahrungsmittel	Nahrungsmittel
Nairobi	—
Namensschild	Namensschilder
Namibia	—
Nashorn	Nashörner
Nass	—
Nationalmuseum	Nationalmuseen
Nationalteam	Nationalteams
Nationaltheater	Nationaltheaters
Naturell	Naturelle
Naturgesetz	Naturgesetze
Naturschutzgebiet	Naturschutzgebiete
Naturschutzgesetz	Naturschutzgesetze
Navigationssystem	Navigationssysteme
Nazareth	—
Neapel	—
Nebenprodukt	Nebenprodukte
Nebenzimmer	Nebenzimmer
Negativ	Negative
Nein	Nein	Neins
Neon	—
Nepal	—
Nervensystem	Nervensysteme
Nest	Nester
Net	Nets
Nettoeinkommen	Nettoeinkommen
Netz	Netze
Netzwerk	Netzwerke
Neubaugebiet	Neubaugebiete
Neubrandenburg	—
Neuenburg	—
Neuguinea	—
Neujahr	—
Neujahrskonzert	Neujahrskonzerte
Neuland	—
Neuseeland	Neuseeländer
Neutron	Neutronen
Nevada	—
Nicaragua	Nicaraguas
Nichtmitglied	Nichtmitglieder
Nichts	Nichtse
Nichtstun	—
Nicken	Nicken
Nickerchen	Nickerchen
Niederbayern	—
Niedersachsen	—
Niemandsland	Niemandsländer
Nigeria	Nigerias
Nikosia	—
Nikotin	—
Nitrat	Nitrate
Niveau	Niveaus
Nizza	—
Nordamerika	Nordamerikas
Nordbaden	—
Norddeutschland	—
Nordeuropa	—
Nordirland	—
Norditalien	—
Nordkorea	Nordkoreas
Nordlicht	Nordlichter
Normal	Normale
Norwegen	—
Notebook	Notebooks
Notizbuch	Notizbücher
Novum	Nova
Nummernschild	Nummernschilder
Nutzfahrzeug	Nutzfahrzeuge
Nutztier	Nutztiere
Nutzungskonzept	Nutzungskonzepte
Nutzungsrecht	Nutzungsrechte
Obdach	—
Oberdorf	Oberdörfer
Obergericht	Obergerichte
Obergeschoss	Obergeschosse
Oberhaupt	Oberhäupter
Oberhaus	Oberhäuser
Oberkommando	Oberkommandos
Oberland	—
Oberlandesgericht	Oberlandesgerichte
Oberstufenzentrum	Oberstufenzentren
Oberverwaltungsgericht	Oberverwaltungsgerichte
Objekt	Objekte
Objektiv	Objektive
Observatorium	Observatorien
Obst	—
Odeon	Odeons
Odessa	—
Ofenloch	Ofenlöcher
Offert	Offerte
Oh	Ohs
Ohr	Ohren
Oktoberfest	Oktoberfeste
Oldenburg	—
Olympiastadion	Olympiastadien
Omega	Omegas
Omen	Omen	Omina
Opernhaus	Opernhäuser
Opfer	Opfer
Opium	—
Optimum	Optima
Opus	Opera
Orakel	Orakel
Oratorium	Oratorien
Orchester	Orchester
Ordinariat	Ordinariate
Ordnungsamt	Ordnungsämter
Oregon	—
Organ	Organe
Organisationskomitee	Organisationskomitees
Original	Originale
Ornament	Ornamente
Ortsbild	Ortsbilder
Ortszentrum	Ortszentren
Osaka	—
Ostafrika	—
Ostasien	—
Ostberlin	—
Ostdeutschland	—
Osterei	Ostereier
Osterfest	Osterfeste
Ostern	Ostern
Osteuropa	Osteuropas
Ostfriesland	—
Osttimor	—
Osttirol	—
Outdoor	Outdoors
Outfit	Outfits
Outsourcing	—
Oval	Ovale
Ozonloch	Ozonlöcher
Paar	Paare
Paarkreuz	Paarkreuze
Padua	—
Paisley	—
Paket	Pakete
Pakistan	—
Palais	Palais
Palermo	—
Palästina	Palästinas
Pamphlet	Pamphlete
Panel	Panels
Panorama	Panoramen
Paper	Papers	Paper
Papier	Papiere
Paradebeispiel	Paradebeispiele
Paradies	Paradiese
Paradigma	Paradigmen	Paradigmata
Paradox	Paradoxe
Parfum	Parfums
Parkdeck	Parkdecks
Parken	Parken
Parkett	Parkette
Parkhaus	Parkhäuser
Parlament	Parlamente
Parma	—
Parteibuch	Parteibücher
Parteiengesetz	Parteiengesetze
Parteimitglied	Parteimitglieder
Parteiprogramm	Parteiprogramme
Parterre	Parterres
Partnerland	Partnerländer
Passagierflugzeug	Passagierflugzeuge
Passwort	Passwörter
Patchwork	Patchworks
Patent	Patente
Patentamt	Patentämter
Patentrezept	Patentrezepte
Pathos	—
Patriarchat	Patriarchate
Patt	Patts
Pech	Peche
Pedal	Pedale
Peking	—
Pendant	Pendants
Pendel	Pendel
Pennsylvania	—
Pensionsalter	Pensionsalter
Pensum	Pensen	Pensa
Persien	—
Personal	—
Peru	—
Pestizid	Pestizide
Petroleum	—
Pfand	Pfänder
Pfarramt	Pfarrämter
Pfarrhaus	Pfarrhäuser
Pfeifkonzert	Pfeifkonzerte
Pferd	Pferde
Pferderennen	Pferderennen
Pfingsten	Pfingsten
Pflanzenschutzmittel	Pflanzenschutzmittel
Pflaster	Pflaster
Pflegegeld	Pflegegelder
Pflegeheim	Pflegeheime
Pflegepersonal	—
Pflichtspiel	Pflichtspiele
Pfund	Pfunde
Pförtnerhaus	Pförterhäuser
Phantom	Phantome
Phantombild	Phantombilder
Pharmaunternehmen	Pharmaunternehmen
Photo	Photos
Photon	Photonen
Piano	Pianos
Pickerl	Pickerl	Pickerln
Picknick	Picknicke
Piepsen	Piepsen
Piercing	Piercings
Pilotprojekt	Pilotprojekte
Pils	Pils
Pixel	Pixel
Placebo	Placebos
Plagiat	Plagiate
Plakat	Plakate
Planetarium	Planetarien
Planfeststellungsverfahren	Planfeststellungsverfahren
Plankton	—
Planspiel	Planspiele
Planungsreferat	Planungsreferate
Plasma	Plasmas
Plateau	Plateaus
Platin	—
Platt	—
Platzangebot	Platzangebote
Plebiszit	Plebiszite
Plenum	Plenen	Plena
Plus	Plusse
Plutonium	—
Plätzchen	Plätzchen
Podium	Podien
Pokalfinale	Pokalfinale	Pokalfinals
Pokalspiel	Pokalspiele
Polieren	Polieren
Politikum	Politika
Polizeiaufgebot	Polizeiaufgebote
Polizeiauto	Polizeiautos
Polizeigesetz	Polizeigesetze
Polizeipräsidium	Polizeipräsidien
Polizeirevier	Polizeireviere
Polnisch	—
Polo	—
Poltern	Poltern
Popcorn	Popcorns
Portal	Portale
Portefeuille	Portefeuilles
Portemonnaie	Portemonnaies
Portfolio	Portfolios
Porto	Portos	Porti
Portrait	Portraits
Porträt	Porträts
Portugal	—
Porzellan	Porzellane
Positionspapier	Positionspapiere
Postamt	Postämter
Postauto	Postautos
Postfach	Postfächer
Postulat	Postulate
Pot	—
Potential	Potentiale
Potenzial	Potenziale
Potpourri	Potpourris
Potsdam	—
Pound	Pounds
Powerplay	Powerplays
Prag	—
Praktikum	Praktika
Preisgeld	Preisgelder
Preisniveau	Preisniveaus
Pressezentrum	Pressezentren
Prestige	—
Pretoria	—
Printmedium	Printmedien
Prinzenpaar	Prinzenpaare
Prinzip	Prinzipien	Prinzipe
Prisma	Prismen
Privateigentum	Privateigentume
Privatfernsehen	—
Privathaus	Privathäuser
Privatleben	Privatleben
Privatradio	Privatradios
Privatunternehmen	Privatunternehmen
Privileg	Privilegien
Privilegium	Privilegien
Problem	Probleme
Produkt	Produkte
Profil	Profile
Programm	Programme
Programmheft	Programmhefte
Projekt	Projekte
Projektil	Projektile
Projektmanagement	—
Proletariat	—
Promille	Promille
Protein	Proteine
Protektorat	Protektorate
Protestieren	Protestieren
Protokoll	Protokolle
Proton	Protonen
Provisorium	Provisorien
Prozedere	Prozedere
Prozent	Prozente
Präsent	Präsente
Präsidium	Präsidien
Pseudonym	Pseudonyme
Psychopharmakon	Psychopharmaka
Publikum	Publika
Pult	Pulte
Pulver	Pulver
Pulverfass	Pulverfässer
Punktspiel	Punktspiele
Puppentheater	Puppentheater
Puzzle	Puzzles
Päckchen	Päckchen
Pärchen	Pärchen
Quadrat	Quadrate
Qualifikationsspiel	Qualifikationsspiele
Qualifikationsturnier	Qualifikationsturniere
Quantum	Quanten
Quartal	Quartale
Quartett	Quartette
Quartier	Quartiere
Quecksilber	—
Quintett	Quintette
Quiz	Quiz
Rad	Räder
Radikal	Radikale
Radio	Radios
Radioprogramm	Radioprogramme
Radl	Radln
Radrennen	Radrennen
Rahmenprogramm	Rahmenprogramme
Rampenlicht	Rampenlichter
Rangun	—
Ranking	Rankings
Rascheln	Rascheln
Rathaus	Rathäuser
Rating	Ratings
Ratsmitglied	Ratsmitglieder
Raubtier	Raubtiere
Rauchen	Rauchen
Rauchverbot	Rauchverbote
Raumordnungsverfahren	Raumordnungsverfahren
Raumschiff	Raumschiffe
Rauschen	Rauschen
Rauschgift	Rauschgifte
Reagenzglas	Reagenzgläser
Rechenzentrum	Rechenzentren
Rechnungswesen	—
Recht	Rechte
Rechteck	Rechtecke
Rechtsgutachten	Rechtsgutachten
Rechtsmittel	Rechtsmittel
Rechtssystem	Rechtssysteme
Reck	Recke
Recklinghausen	—
Recycling	Recyclings
Redaktionsmitglied	Redaktionsmitglieder
Rednerpult	Rednerpulte
Referat	Referate
Referendum	Referenden	Referenda
Reformprogramm	Reformprogramme
Reformvorhaben	Reformvorhaben
Refugium	Refugien
Regal	Regale
Regelwerk	Regelwerke
Regensburg	—
Regenwasser	—
Regierungsamt	Regierungsämter
Regierungslager	Regierungslager
Regierungsmitglied	Regierungsmitglieder
Regierungsprogramm	Regierungsprogramme
Regierungsviertel	Regierungsviertel
Regime	Regime
Regiment	Regimenter
Register	Register
Reglement	Reglements	Reglemente
Reh	Rehe
Reich	Reiche
Reihenhaus	Reihenhäuser
Reinigungsmittel	Reinigungsmittel
Reisebüro	Reisebüros
Reiseunternehmen	Reiseunternehmen
Reiseziel	Reiseziele
Reiten	Reiten
Rekordergebnis	Rekordergebnisse
Rekordjahr	Rekordjahre
Rekordtief	Rekordtiefs
Relativ	Relative
Relegationsspiel	Relegationsspiele
Relief	Reliefs	Reliefe
Relikt	Relikte
Rem	Rems
Remake	Remakes
Remis	Remis	Remisen
Rendezvous	Rendezvous
Rennen	Rennen
Rennrad	Rennräder
Renommee	Renommees
Rentenalter	Rentenalter
Rentensystem	Rentensysteme
Repertoire	Repertoires
Reptil	Reptilien
Requiem	Requiems	Requien
Requisit	Requisiten
Reservat	Reservate
Reservoir	Reservoire
Ressentiment	Ressentiments
Ressort	Ressorts
Restaurant	Restaurants
Restrisiko	Restrisiken	Restrisikos
Resultat	Resultate
Revier	Reviere
Revival	Revivals
Rezept	Rezepte
Rheinhessen	—
Rheinland	—
Rheintal	—
Rheinufer	Rheinufer
Rheuma	—
Riad	—
Richtfest	Richtfeste
Rick	Ricke
Riesenrad	Riesenräder
Riga	—
Rimini	—
Rind	Rinder
Rindfleisch	Rindfleische
Ringen	Ringen
Rippchen	Rippchen
Risiko	Risikos	Risiken	Risken
Risikokapital	—
Rita	—
Ritual	Rituale	Ritualien
Rockkonzert	Rockkonzerte
Rohr	Rohre
Rokoko	—
Rollenspiel	Rollenspiele
Rondo	Rondos
Rostock	—
Rot	Rots
Rotlicht	—
Rotterdam	—
Rouge	Rouges
Roulette	Rouletten
Ruanda	—
Rudel	Rudel
Ruder	Ruder
Rugby	Rugbys
Ruhrgebiet	—
Rumänien	—
Rund	Runde
Rundschreiben	Rundschreiben
Russisch	—
Röntgen	Röntgen
Röntgenbild	Röntgenbilder
Rülpsen	Rülpsen
Rütteln	Rütteln
Saarland	—
Saatgut	—
Sachbuch	Sachbücher
Sachsen	—
Saigon	—
Saisonende	Saisonenden
Saisonfinale	Saisonfinale	Saisonfinali
Saisonspiel	Saisonspiele
Saisontor	Saisontore
Saisonziel	Saisonziele
Sakrament	Sakramente
Saloniki	—
Salz	Salze
Salzkammergut	—
Salzwasser	Salzwasser	Salzwässer
Sambia	—
Sammelsurium	Sammelsurien
Sanatorium	Sanatorien
Sanierungsgebiet	Sanierungsgebiete
Sanierungskonzept	Sanierungskonzepte
Sanierungsprogramm	Sanierungsprogramme
Sarajevo	—
Sardinien	—
Sauerkraut	—
Sauerland	—
Schach	Schachs
Schachmatt	Schachmatts
Schachspiel	Schachspiele
Schaf	Schafe
Schaffhausen	—
Schanghai	—
Schattendasein	—
Schaufenster	Schaufenster
Schauspiel	Schauspiele
Schauspielhaus	Schauspielhäuser
Scheinwerferlicht	Scheinwerferlichter
Scheitern	Scheitern
Schema	Schemas
Scherzo	Scherzos
Schicksal	Schicksale
Schiedsgericht	Schiedsgerichte
Schienbein	Schienbeine
Schienennetz	Schienennetze
Schießeisen	Schießeisen
Schießpulver	Schießpulver
Schiff	Schiffe
Schilf	Schilfe
Schimpfwort	Schimpfwörter
Schlachtfeld	Schlachtfelder
Schlafzimmer	Schlafzimmer
Schlaglicht	Schlaglichter
Schlagloch	Schlaglöcher
Schlagwort	Schlagwörter	Schlagworte
Schlagzeug	Schlagzeuge
Schlaraffenland	—
Schlauchboot	Schlauchboote
Schlechtwetter	—
Schlepptau	Schlepptaue
Schlesien	—
Schleswig	—
Schließfach	Schließfächer
Schloss	Schlösser
Schlupfloch	Schlupflöcher
Schlussdrittel	Schlussdrittel
Schlusslicht	Schlusslichter
Schlusswort	Schlussworte
Schläfchen	Schläfchen
Schlückchen	Schlückchen
Schlüsselbein	Schlüsselbeine
Schlüsselloch	Schlüssellöcher
Schmankerl	Schmankerl	Schmankerln
Schmerzensgeld	Schmerzensgelder
Schmerzmittel	Schmerzmittel
Schmiergeld	Schmiergelder
Schneebrett	Schneebretter
Schneetreiben	—
Schneewittchen	—
Schnellverfahren	Schnellverfahren
Schnitzel	Schnitzel
Schnupfen	Schnupfen
Schnäppchen	Schnäppchen
Schottland	—
Schreckgespenst	Schreckgespenster
Schreiben	Schreiben
Schriftzeichen	Schriftzeichen
Schuhwerk	Schuhwerke
Schulamt	Schulämter
Schulbuch	Schulbücher
Schulfest	Schulfeste
Schulgeld	Schulgelder
Schulgesetz	Schulgesetze
Schulhaus	Schulhäuser
Schuljahr	Schuljahre
Schulkind	Schulkinder
Schulprojekt	Schulprojekte
Schulsystem	Schulsysteme
Schulwesen	—
Schulzentrum	Schulzentren
Schulzimmer	Schulzimmer
Schutzgebiet	Schutzgebiete
Schwarz	—
Schwarzgeld	Schwarzgelder
Schwarzweiß	—
Schweden	—
Schwedisch	—
Schwefeldioxid	—
Schweigen	Schweigen
Schwein	Schweine
Schweinchen	Schweinchen
Schweinefleisch	Schweinefleische
Schwellen	Schwellen
Schwellenland	Schwellenländer
Schwergewicht	Schwergewichte
Schwermetall	Schwermetalle
Schwerpunktthema	Schwerpunktthemata	Schwerpunktthemen
Schwert	Schwerter
Schwimmbad	Schwimmbäder
Schwimmbecken	Schwimmbecken
Schwimmen	Schwimmen
Schwurgericht	Schwurgerichte
Schätzchen	Schätzchen
Sediment	Sedimente
Seebad	Seebäder
Seeufer	Seeufer
Segel	Segel
Segelboot	Segelboote
Segelschiff	Segelschiffe
Segment	Segmente
Sehnen	Sehnen
Seidel	Seidel
Seil	Seile
Sekretariat	Sekretariate
Selbst	—
Selbstbestimmungsrecht	Selbstbestimmungsrechte
Selbstbewusstsein	—
Selbstbild	Selbstbilder
Selbstbildnis	Selbstbildnisse
Selbstmitleid	—
Selbstvertrauen	—
Semester	Semester
Semifinale	Semifinale	Semifinals
Seminar	Seminare	Seminarien
Seniorenheim	Seniorenheime
Seoul	—
Serbien	—
Serum	Seren
Service	Services
Sextett	Sextette
Sexualdelikt	Sexualdelikte
Shampoo	Shampoos
Shirt	Shirts
Shopping	Shoppings
Showbusiness	—
Showgeschäft	—
Sibirien	—
Sicherheitskonzept	Sicherheitskonzepte
Sicherheitsproblem	Sicherheitsprobleme
Sicherheitsrisiko	Sicherheitsrisikos
Sicherheitssystem	Sicherheitssysteme
Sieb	Siebe
Siedlungsgebiet	Siedlungsgebiete
Siegel	Siegel
Signal	Signale
Signet	Signets	Signete
Silber	—
Silikon	Silikone
Silizium	—
Simbabwe	—
Sinfonieorchester	Sinfonieorchester
Single	Singlen	Singlen
Singspiel	Singspiele
Sinnbild	Sinnbilder
Sizilien	—
Skalpell	Skalpelle
Skandinavien	—
Skateboard	Skateboards
Skelett	Skelette
Skigebiet	Skigebiete
Skispringen	Skispringen
Skript	Skripte	Skripten	Skripts
Slowenien	—
Snowboard	Snowboards
Sofa	Sofas
Sofia	—
Sofortprogramm	Sofortprogramme
Softwarehaus	Softwarehäuser
Solarium	Solarien
Solingen	—
Solo	Solos
Somalia	—
Sommerfest	Sommerfeste
Sommerloch	Sommerlöcher
Sommersemester	Sommersemester
Sommertheater	Sommertheaters
Sommerwetter	—
Sonderangebot	Sonderangebote
Sondermodell	Sondermodelle
Sonderprogramm	Sonderprogramme
Sonnenlicht	—
Sonnensystem	Sonnensysteme
Sorgenkind	Sorgenkinder
Sorgerecht	Sorgerechte
Sortiment	Sortimente
Souvenir	Souvenirs
Sozialamt	Sozialämter
Sozialgericht	Sozialgerichte
Sozialministerium	Sozialministerien
Sozialprodukt	Sozialprodukte
Sozialsystem	Sozialsysteme
Sozialwesen	Sozialwesen
Spalier	Spaliere
Spanien	—
Spanisch	—
Spannungsfeld	Spannungsfelder
Sparbuch	Sparbücher
Sparpaket	Sparpakete
Sparprogramm	Sparprogramme
Sparta	—
Special	Specials
Spektrum	Spektren
Spendengeld	Spendengelder
Spendenkonto	Spendenkonten	Spendenkontos	Spendenkonti
Sperma	Spermas
Sperrgebiet	Sperrgebiete
Speyer	—
Spezialgebiet	Spezialgebiete
Spiegelbild	Spiegelbilder
Spiel	Spiele
Spielcasino	Spielcasinos
Spielfeld	Spielfelder
Spielzeug	Spielzeuge
Spital	Spitäler
Spitzenspiel	Spitzenspiele
Spitzenteam	Spitzenteams
Sponsorengeld	Sponsorengelder
Sponsoring	Sponsorings
Sportabzeichen	Sportabzeichen
Sportamt	Sportämter
Sportereignis	Sportereignisse
Sportfest	Sportfeste
Sportgericht	Sportgerichte
Sportstudio	Sportstudios
Sportzentrum	Sportzentren
Sprachrohr	Sprachrohre
Sprichwort	Sprichwörter
Spruchband	Spruchbänder
Sprungbrett	Sprungbretter
Sprunggelenk	Sprunggelenke
Spurenelement	Spurenelemente
Squash	—
Staatsamt	Staatsämter
Staatsarchiv	Staatsarchive
Staatsexamen	Staatsexamen	Staatsexamina
Staatsfernsehen	—
Staatsgebiet	Staatsgebiete
Staatsoberhaupt	Staatsoberhäupter
Staatstheater	Staatstheater
Staatsunternehmen	Staatsunternehmen
Staatswesen	Staatswesen
Stadion	Stadien
Stadium	Stadien
Stadtarchiv	Stadtarchive
Stadtbild	Stadtbilder
Stadtfest	Stadtfeste
Stadtgebiet	Stadtgebiete
Stadthaus	Stadthäuser
Stadtmarketing	—
Stadtmuseum	Stadtmuseen
Stadtoberhaupt	Stadtoberhäupter
Stadtparlament	Stadtparlamente
Stadtrecht	Stadtrechte
Stadtschloss	Stadtschlösser
Stadttheater	Stadttheaters
Stadtviertel	Stadtviertel
Stadtzentrum	Stadtzentren
Stahlwerk	Stahlwerke
Stalingrad	—
Stammbuch	Stammbücher
Stammhaus	Stammhäuser
Stammkapital	Stammkapitale
Stammwerk	Stammwerke
Standardwerk	Standardwerke
Standbein	Standbeine
Standbild	Standbilder
Standesamt	Standesämter
Startgeld	Startgelder
Startkapital	Startkapitale	Startkapitalien
Startloch	Startlöcher
Statement	Statements
Statussymbol	Statussymbole
Statut	Statuten
Staunen	Staunen
Steak	Steaks
Steckenpferd	Steckenpferde
Steinhaus	Steinhäuser
Stelldichein	Stelldichein	Stelldicheins
Stellenangebot	Stellenangebote
Stellwerk	Stellwerke
Stereo	Stereos
Stereotyp	Stereotype
Sternbild	Sternbilder
Sternchen	Sternchen
Sternzeichen	Sternzeichen
Stettin	—
Steueraufkommen	Steueraufkommen
Steuergeld	Steuergelder
Steuergesetz	Steuergesetze
Steuerrecht	Steuerrechte
Stichwort	Stichwörter
Sticken	Sticken
Stickoxid	Stickoxide
Stiefkind	Stiefkinder
Stiegenhaus	Stiegenhäuser
Stigma	Stigmata	Stigmen
Stillen	Stillen
Stillschweigen	—
Stilmittel	Stilmittel
Stimmrecht	Stimmrechte
Stimmungsbild	Stimmungsbilder
Stinktier	Stinktiere
Stipendium	Stipendien
Stockerl	Stockerln
Stockholm	—
Stockwerk	Stockwerke
Stottern	Stottern
Strafgericht	Strafgerichte
Strafgesetzbuch	Strafgesetzbücher
Strafrecht	—
Strafverfahren	Strafverfahren
Stralsund	—
Strandbad	Strandbäder
Strategiepapier	Strategiepapiere
Streckennetz	Streckennetze
Streichholz	Streichhölzer
Streichquartett	Streichquartette
Streiflicht	Streiflichter
Stroh	—
Stromnetz	Stromnetze
Strukturproblem	Strukturprobleme
Studentenwerk	Studentenwerke
Studienjahr	Studienjahre
Studio	Studios
Studium	Studien
Stuttgart	—
Styling	Stylings
Stäbchen	Stäbchen
Ständchen	Ständchen
Stöckchen	Stöckchen
Stück	Stücke
Stückchen	Stückchen
Subjekt	Subjekte
Suchtgift	Suchtgifte
Sujet	Sujets
Sumatra	—
Surfen	Surfen
Surren	Surren
Sushi	Sushis
Sydney	—
Symbol	Symbole
Symphonieorchester	Symphonieorchester
Symposion	Symposien
Symposium	Symposien
Symptom	Symptome
Syndikat	Syndikate
Syndrom	Syndrome
Synonym	Synonyme	Synonyma
System	Systeme
Systemhaus	Systemhäuser
Szenario	Szenarien	Szenarios
Szenarium	Szenarien
Sägemehl	Sägemehle
Sägewerk	Sägewerke
Säugetier	Säugetiere
Söhnchen	Söhnchen
Südafrika	Südafrikas
Südamerika	Südamerikas
Tabellenende	Tabellenenden
Tableau	Tableaus
Tablett	Tabletts	Tablette
Tabu	Tabus
Tabuthema	Tabuthemen	Tabuthemata
Tadschikistan	—
Tagblatt	Tagblätter
Tagebuch	Tagebücher
Tageslicht	—
Tagesthema	Tagesthemen
Tahiti	—
Taipeh	—
Taiwan	—
Tal	Täler
Talent	Talente
Tallinn	—
Tamil	—
Tandem	Tandems
Tansania	—
Tanzbein	Tanzbeine
Tanztheater	Tanztheaters
Taschenbuch	Taschenbücher
Taschengeld	Taschengelder
Taschentuch	Taschentücher
Taschkent	—
Tatmotiv	Tatmotive
Tausend	Tausend
Tauwetter	—
Tauziehen	—
Team	Teams
Teamwork	—
Technologiezentrum	Technologiezentren
Teheran	—
Teilchen	Teilchen
Teilnehmerfeld	Teilnehmerfelder
Telefax	Telefaxe
Telefon	Telefone
Telefonat	Telefonate
Telefonbuch	Telefonbücher
Telefongespräch	Telefongespräche
Telefonnetz	Telefonnetze
Telegramm	Telegramme
Telekommunikationsunternehmen	Telekommunikationsunternehmen
Teleskop	Teleskope
Temperament	Temperamente
Tempo	Tempi	Tempos
Tempolimit	Tempolimits	Tempolimite
Teneriffa	—
Tennis	—
Tennisturnier	Tennisturniere
Terrain	Terrains
Territorium	Territorien
Testament	Testamente
Testergebnis	Testergebnisse
Testosteron	—
Testspiel	Testspiele
Texas	—
Textil	—
Thailand	—
Theater	Theater
Theatertreffen	Theatertreffen
Thema	Themas
Thermalbad	Thermalbäder
Thessaloniki	—
Thing	Thinge
Ticket	Tickets
Tief	Tiefs
Tiefbauamt	Tiefbauämter
Tier	Tiere
Tierchen	Tierchen
Tierfutter	—
Tierheim	Tierheime
Tiermehl	Tiermehle
Tierschutzgesetz	Tierschutzgesetze
Timbre	Timbres
Timing	Timings
Tirana	—
Tirol	—
Tischtennis	—
Titelbild	Titelbilder
Titelblatt	Titelblätter
Toben	Toben
Tochterunternehmen	Tochterunternehmen
Todesopfer	Todesopfer
Todesurteil	Todesurteile
Togo	—
Toilettenpapier	Toilettenpapiere
Tokio	—
Tonband	Tonbänder
Tonbandgerät	Tonbandgeräte
Tonstudio	Tonstudios
Tool	Tools
Tor	Tore
Toronto	—
Traditionsunternehmen	Traditionsunternehmen
Training	Trainings
Trainingscamp	Trainingscamps
Trainingslager	Trainingslager
Trainingsprogramm	Trainingsprogramme
Traktandum	Traktanden
Trampolin	Trampoline
Transparent	Transparente
Transportflugzeug	Transportflugzeuge
Transportmittel	Transportmittel
Transportunternehmen	Transportunternehmen
Trauerspiel	Trauerspiele
Trauma	Traumen	Traumata
Traumpaar	Traumpaare
Treffen	Treffen
Treiben	Treiben
Treibhaus	Treibhäuser
Treibhausgas	Treibhausgase
Trekking	—
Treppchen	Treppchen
Treppenhaus	Treppenhäuser
Tribunal	Tribunale
Triebwerk	Triebwerke
Trier	—
Triest	—
Trinidad	—
Trinkgeld	Trinkgelder
Trinkwasser	Trinkwasser	Trinkwässer
Trio	Trios
Troja	—
Tropenholz	Tropenhölzer
Trostpflaster	Trostpflaster
Trottoir	Trottoirs	Trottoire
Tränengas	Tränengase
Tschechien	—
Tuch	Tücher
Tunesien	—
Tunis	—
Turin	—
Turnfest	Turnfeste
Turnier	Turniere
Tutti	Tuttis
Tänzchen	Tänzchen
Töchterchen	Töchterchen
Töpfchen	Töpfchen
Törtchen	Törtchen
Türkisch	—
Ufer	Ufer
Ufo	Ufos
Uganda	—
Uhrwerk	Uhrwerke
Ultimatum	Ultimatums
Umfeld	Umfelder
Umfrageergebnis	Umfrageergebnisse
Umland	—
Umsatzplus	Umsatzplus	Umsatzplusse
Umsatzvolumen	Umsatzvolumen	Umsatzvolumina
Umsatzwachstum	—
Umweltbewusstsein	—
Umweltbundesamt	—
Umweltministerium	Umweltministerien
Unbehagen	—
Unding	Undinge
Unentschieden	Unentschieden
Unfallkrankenhaus	Unfallkrankenhäuser
Unfallopfer	Unfallopfer
Ungarisch	—
Ungarn	—
Ungeheuer	Ungeheuer
Ungemach	—
Ungleichgewicht	Ungleichgewichte
Unheil	—
Unikat	Unikate
Universum	Universen
Unkraut	Unkräuter
Unrecht	Unrechte
Unterbewusstsein	—
Unterfangen	Unterfangen
Unterfranken	—
Untergeschoss	Untergeschosse
Unterhaltungsprogramm	Unterhaltungsprogramme
Unterhaus	Unterhäuser
Unterholz	Unterhölzer
Unterland	Unterländer
Unternehmen	Unternehmen
Unternehmertum	—
Unterrichtsministerium	Unterrichtsministerien
Untersuchungsergebnis	Untersuchungsergebnisse
Unterwasser	Unterwasser
Unwesen	—
Unwetter	Unwetter
Update	Updates
Uran	—
Urgestein	Urgesteine
Urheberrecht	Urheberrechte
Uri	—
Urlaubsgeld	Urlaubsgelder
Urlaubsland	Urlaubsländer
Urlaubsziel	Urlaubsziele
Urteil	Urteile
Urteilsvermögen	—
Usbekistan	—
Uta	Uta
Utah	—
Utrecht	—
Vaduz	—
Vakuum	Vakua	Vakuen
Valencia	—
Vancouver	—
Vaterland	Vaterländer
Vehikel	Vehikel
Veilchen	Veilchen
Velo	Velos
Velodrom	Velodrome
Venedig	—
Venezuela	—
Ventil	Ventile
Verantwortungsbewusstsein	—
Verb	Verben
Verbot	Verbote
Verbrechen	Verbrechen
Verdachtsmoment	Verdachtsmomente
Verderben	Verderben
Verdikt	Verdikte
Vereinshaus	Vereinshäuser
Vereinsheim	Vereinsheime
Vereinsleben	—
Vereinsmitglied	Vereinsmitglieder
Verfahren	Verfahren
Verfassungsgericht	Verfassungsgerichte
Vergehen	Vergehen
Vergnügen	Vergnügen
Verhalten	Verhalten
Verhaltensmuster	Verhaltensmuster
Verhandlungsergebnis	Verhandlungsergebnisse
Verhältnis	Verhältnisse
Verhängnis	Verhängnisse
Verkehrsaufkommen	Verkehrsaufkommen
Verkehrschaos	—
Verkehrsflugzeug	Verkehrsflugzeuge
Verkehrskonzept	Verkehrskonzepte
Verkehrsministerium	Verkehrsministerien
Verkehrsmittel	Verkehrsmittel
Verkehrsnetz	Verkehrsnetze
Verkehrsproblem	Verkehrsprobleme
Verkehrsprojekt	Verkehrsprojekte
Verkehrsschild	Verkehrsschilder
Verkehrsunternehmen	Verkehrsunternehmen
Verkehrswesen	—
Verkehrszeichen	Verkehrszeichen
Verlagshaus	Verlagshäuser
Verlangen	Verlangen
Verletzungspech	—
Vermittlungsverfahren	Vermittlungsverfahren
Vermächtnis	Vermächtnisse
Vermögen	Vermögen
Vernichtungslager	Vernichtungslager
Verona	—
Versagen	Versagen
Versandhaus	Versandhäuser
Verschulden	Verschulden
Versehen	Versehen
Versicherungsunternehmen	Versicherungsunternehmen
Versprechen	Versprechen
Versteck	Verstecke
Verständnis	Verständnisse
Verteidigungsministerium	Verteidigungsministerien
Verteilen	Verteilen
Vertragswerk	Vertragswerke
Vertrauen	Vertrauen
Verwaltungsgericht	Verwaltungsgerichte
Verweilen	Verweilen
Verwirrspiel	Verwirrspiele
Verzeichnis	Verzeichnisse
Veto	Vetos
Vetorecht	Vetorechte
Video	Videos
Videoband	Videobänder
Videospiel	Videospiele
Viech	Viecher
Vieh	Viecher
Viertel	Viertel
Viertelfinale	Viertelfinale
Vierteljahr	Vierteljahre
Vierteljahrhundert	Vierteljahrhunderte
Vietnam	—
Violett	—
Violinkonzert	Violinkonzerte
Violoncello	Violoncelli	Violoncellos
Visier	Visiere
Visum	Visa	Visen
Vitamin	Vitamine
Vokabular	Vokabulare
Volk	Völker
Volksbegehren	Volksbegehren
Volksfest	Volksfeste
Volkshaus	Volkshäuser
Volkslied	Volkslieder
Volkstheater	Volkstheaters
Vollgas	—
Volt	Volt
Volumen	Volumen	Volumina
Vorarlberg	—
Vorbereitungsspiel	Vorbereitungsspiele
Vorbild	Vorbilder
Vorderrad	Vorderräder
Vorfeld	Vorfelder
Vorgehen	Vorgehen
Vorhaben	Vorhaben
Vorhandensein	—
Vorjahr	Vorjahre
Vorjahresergebnis	Vorjahresergebnisse
Vorjahresniveau	Vorjahresniveaus
Vorkaufsrecht	Vorkaufsrechte
Vorkommen	Vorkommen
Vorkommnis	Vorkommnisse
Vorprogramm	Vorprogramme
Vorrecht	Vorrechte
Vorrundenspiel	Vorrundenspiele
Vorschlagsrecht	Vorschlagsrechte
Vorspiel	Vorspiele
Vorspielen	Vorspielen
Vorstandsmitglied	Vorstandsmitglieder
Vorstellungsgespräch	Vorstellungsgespräche
Vortäuschen	Vortäuschen
Vorurteil	Vorurteile
Vorwort	Vorworte
Vorzeichen	Vorzeichen
Vorzimmer	Vorzimmer
Votum	Vota	Voten
Vögelchen	Vögelchen
Vöglein	Vöglein
Wachs	Wachse
Wachstum	—
Wachstumshormon	Wachstumshormone
Wachzimmer	Wachzimmer
Waffenarsenal	Waffenarsenale
Waffenembargo	Waffenembargos
Waffengesetz	Waffengesetze
Waffenlager	Waffenlager	Waffenläger
Waffensystem	Waffensysteme
Wagnis	Wagnisse
Wahlergebnis	Wahlergebnisse
Wahlgesetz	Wahlgesetze
Wahljahr	Wahljahre
Wahlkampfthema	Wahlkampfthemen
Wahllokal	Wahllokale
Wahlplakat	Wahlplakate
Wahlprogramm	Wahlprogramme
Wahlrecht	Wahlrechte
Wahlversprechen	Wahlversprechen
Wahlvolk	—
Wahrzeichen	Wahrzeichen
Waisenhaus	Waisenhäuser
Waisenkind	Waisenkinder
Waldeck	—
Waldgebiet	Waldgebiete
Waldviertel	—
Wales	—
Wallis	—
Wandbild	Wandbilder
Wandern	Wandern
Wappen	Wappen
Warenhaus	Warenhäuser
Warmwasser	—
Warnsignal	Warnsignale
Warschau	—
Wartezimmer	Wartezimmer
Waschbecken	Waschbecken
Waschmittel	Waschmittel
Wasser	Wasser
Wasserglas	Wassergläser
Wasserkraftwerk	Wasserkraftwerke
Wasserspiel	Wasserspiele
Wasserwerk	Wasserwerke
Waterloo	Waterloos
Wattenmeer	Wattenmeere
Web	—
Wechselbad	Wechselbäder
Wechselgeld	Wechselgelder
Wechselspiel	Wechselspiele
Weekend	Weekends
Weib	Weiber
Weibchen	Weibchen
Weihnachten	Weihnachten
Weihnachtsfest	Weihnachtsfeste
Weihnachtsgeld	Weihnachtsgelder
Weihnachtsgeschenk	Weihnachtsgeschenke
Weihnachtslied	Weihnachtslieder
Weilchen	Weilchen
Weimar	—
Weinfeld	Weinfelder
Weingut	Weingüter
Weltall	—
Weltbild	Weltbilder
Weltcuprennen	Weltcuprennen
Welterbe	Welterbe	Welterben
Weltkulturerbe	—
Weltmeer	Weltmeere
Weltwirtschaftsforum	Weltwirtschaftsforen
Werbeplakat	Werbeplakate
Werbeverbot	Werbeverbote
Werk	Werke
Werkzeug	Werkzeuge
Wertpapier	Wertpapiere
Wertpapierhaus	Wertpapierhäuser
Wesen	Wesen
Westafrika	—
Westberlin	—
Westdeutschland	—
Westeuropa	—
Westjordanland	—
Westniveau	Westniveaus
Wettbewerbsrecht	Wettbewerbsrechte
Wettrennen	Wettrennen
Wetzlar	—
Wiederfinden	Wiederfinden
Wiedersehen	Wiedersehen
Wien	—
Wiesbaden	—
Wiesel	Wiesel
Wild	—
Wildschwein	Wildschweine
Wildtier	Wildtiere
Wildwasser	Wildwasser
Wilhelmshaven	—
Willkommen	Willkommen
Wimmern	Wimmern
Windrad	Windräder
Winseln	Winseln
Winterquartier	Winterquartiere
Wintersemester	Wintersemester
Wirtschaftsforschungsinstitut	Wirtschaftsforschungsinstitute
Wirtschaftsleben	—
Wirtschaftsmagazin	Wirtschaftsmagazine
Wirtschaftsministerium	Wirtschaftsministerien
Wirtschaftsressort	Wirtschaftsressorten
Wirtschaftssystem	Wirtschaftssysteme
Wirtschaftsunternehmen	Wirtschaftsunternehmen
Wirtschaftswachstum	—
Wirtschaftswunder	Wirtschaftswunder
Wirtshaus	Wirtshäuser
Wissenschaftsministerium	Wissenschaftsministerien
Wittenberg	—
Wochenblatt	Wochenblätter
Wochenende	Wochenenden
Wohl	—
Wohlbefinden	—
Wohlergehen	—
Wohlfühlen	Wohlfühlen
Wohlgefallen	—
Wohneigentum	Wohneigentümer
Wohngebiet	Wohngebiete
Wohngeld	Wohngelder
Wohnhaus	Wohnhäuser
Wohnheim	Wohnheime
Wohnmobil	Wohnmobile
Wohnquartier	Wohnquartiere
Wohnungsunternehmen	Wohnungsunternehmen
Wohnviertel	Wohnviertel
Wohnzimmer	Wohnzimmer
Worms	—
Wort	Wörter
Wortgefecht	Wortgefechte
Wortspiel	Wortspiele
Wrack	Wracks
Wunder	Wunder
Wunderkind	Wunderkinder
Wunderland	Wunderländer
Wundermittel	Wundermittel
Wunderwerk	Wunderwerke
Wunschdenken	—
Würgen	Würgen
Würstchen	Würstchen
Wüten	Wüten
Yang	—
Yard	Yards
Zagreb	—
Zahlenwerk	Zahlenwerke
Zahlungsmittel	Zahlungsmittel
Zauberwort	Zauberworte
Zebra	Zebras
Zehntausend	Zehntausend	Zehntausende
Zeichen	Zeichen
Zeitalter	Zeitalter
Zeitungsinterview	Zeitungsinterviews
Zeltlager	Zeltlager
Zen	—
Zentralasien	—
Zentraleuropa	—
Zentralinstitut	Zentralinstitute
Zentralkomitee	Zentralkomitees
Zentralorgan	Zentralorgane
Zentrum	Zentren
Zertifikat	Zertifikate
Zeug	Zeuge
Zeughaus	Zeughäuser
Zeugnis	Zeugnisse
Ziel	Ziele
Zimmer	Zimmer
Zimmermädchen	Zimmermädchen
Zinn	—
Zinsniveau	Zinsniveaus
Zirkuszelt	Zirkuszelte
Zitat	Zitate
Zivil	—
Zivilgericht	Zivilgerichte
Zollamt	Zollämter
Zubehör	Zubehöre
Zubrot	Zubrote
Zuchthaus	Zuchthäuser
Zucken	Zucken
Zuckerl	Zuckerl	Zuckerln
Zugpferd	Zugpferde
Zuhause	—
Zusammenleben	Zusammenleben
Zusammensein	—
Zusammenspiel	Zusammenspiele
Zusammentreffen	Zusammentreffen
Zuspiel	Zuspiele
Zuwanderungsgesetz	Zuwanderungsgesetze
Zweifamilienhaus	Zweifamilienhäuser
Zweirad	Zweiräder
Zwielicht	—
Zwischenergebnis	Zwischenergebnisse
Zwischenlager	Zwischenlager	Zwischenläger
Zwischenspiel	Zwischenspiele
Zwitschern	Zwitschern
Zyklus	Zyklen
Zypern	—
Zögern	Zögern
Ächzen	Ächzen
Äffchen	Äffchen
Ärgernis	Ärgernisse
Ödland	—
Öl	Öle
Überbleibsel	Überbleibsel