Aal	Aale
Aargau	—
Abbau	Abbaue
Abbruch	Abbrüche
Abdruck	Abdrücke
Abend	Abende
Abenteuerspielplatz	Abenteuerspielplätze
Abenteurer	Abenteurer
Abfahrer	Abfahrer
Abfall	Abfälle
Abflug	Abflüge
Abfluss	Abflüsse
Abgang	Abgänge
Abgeordnete	Abgeordneten
Abgesang	Abgesänge
Abgrund	Abgründe
Abiturient	Abiturienten
Ablauf	Abläufe
Ableger	Ableger
Abmarsch	Abmärsche
Abnehmer	Abnehmer
Abonnent	Abonnenten
Abruf	Abrufe
Absatz	Absätze
Absatzmarkt	Absatzmärkte
Abschaum	—
Abscheu	—
Abschiebestopp	Abschiebestopps
Abschied	Abschiede
Abschiedsbrief	Abschiedsbriefe
Abschlag	Abschläge
Abschluss	Abschlüsse
Abschlussball	Abschlussbälle
Abschlussbericht	Abschlussberichte
Abschnitt	Abschnitte
Abschuss	Abschüsse
Abschwung	Abschwünge
Absender	Absender
Absolvent	Absolventen
Absprung	Absprünge
Abstand	Abstanden
Abstecher	Abstecher
Absteiger	Absteiger
Abstellplatz	Abstellplätze
Abstieg	Abstiege
Abstiegskampf	Abstiegskämpfe
Abstiegskandidat	Abstiegskandidaten
Abstiegsplatz	Abstiegsplätze
Abstract	Abstracts
Abstrich	Abstriche
Absturz	Abstürze
Abt	Äbte
Abteilungsleiter	Abteilungsleiter
Abtransport	Abtransporte
Abwasserverband	Abwasserverbände
Abwehrchef	Abwehrchefs
Abwehrspieler	Abwehrspieler
Abweichler	Abweichler
Abwurf	Abwürfe
Abzug	Abzüge
Achter	Achter
Achtundsechziger	Achtundsechziger
Achtungserfolg	Achtungserfolge
Acker	Äcker	Acker
Ackerbau	—
Ackermann	Ackermänner
Actionfilm	Actionfilme
Adel	—
Aderlass	Aderlässe
Adler	Adler
Administrator	Administratoren
Admiral	Admirale
Adressat	Adressaten
Advent	Advente
Adventskalender	Adventskalender
Advokat	Advokaten
Affe	Affen
Affekt	Affekte
Affront	Affronts
Afghane	Afghanen
Afrikaner	Afrikaner
After	After
Agent	Agenten
Aggressor	Aggressoren
Agrarkommissar	Agrarkommissare
Agrarminister	Agrarminister
Ahn	Ahnen
Ahorn	Ahorne
Airbag	Airbags
Airbus	Airbusse
Ajatollah	Ajatollahs
Akademiker	Akademiker
Akkord	Akkorde
Akku	Akkus
Akrobat	Akrobaten
Akt	Akte
Aktenordner	Aktenordner
Akteur	Akteure
Aktienhandel	—
Aktienindex	Aktienindexe	Aktienindices	Aktienindizes
Aktienkurs	Aktienkurse
Aktienmarkt	Aktienmärkte
Aktientausch	Aktientausche
Aktionismus	Aktionismen
Aktionsplan	Aktionspläne
Aktionstag	Aktionstage
Aktivist	Aktivisten
Aktuar	Aktuare
Akzent	Akzenten
Alarm	Alarme
Albaner	Albaner
Albtraum	Albträume
Algerier	Algerier
Algorithmus	Algorithmen
Alien	Aliens
Alkohol	Alkohole
Alkoholeinfluss	—
Alkoholiker	Alkoholiker
Alkoholismus	—
Alkoholkonsum	—
Allah	—
Alleingang	Alleingänge
Alleinunterhalter	Alleinunterhalter
Allergiker	Allergiker
Alligator	Alligatoren
Allrad	Allräder
Allradantrieb	Allradantriebe
Alltag	Alltage
Alpenraum	Alpenräume
Alpenverein	Alpenvereine
Alpinist	Alpinisten
Alptraum	Alpträume
Altar	Altäre
Altbau	Altbauten
Altbundeskanzler	Altbundeskanzler
Alter	Alter
Altersgenosse	Altersgenossen
Altkanzler	Altkanzler
Altmeister	Altmeister
Alzheimer	—
Amateur	Amateure
Amerikaner	Amerikaner
Ammann	Ammänner
Amok	—
Amoklauf	Amokläufe
Amtsantritt	Amtsantritte
Amtsarzt	Amtsärzte
Amtsinhaber	Amtsinhaber
Amtskollege	Amtskollegen
Amtsleiter	Amtsleiter
Amtsmissbrauch	Amtsmissbräuche
Amtsrichter	Amtsrichter
Amtssitz	Amtssitze
Anachronismus	Anachronismen
Analphabet	Analphabeten
Analyst	Analysten	Analysts
Analytiker	Analytiker
Anarchist	Anarchisten
Anbau	—
Anbeginn	—
Anbieter	Anbieter
Anblick	Anblicke
Andrang	—
Anfall	Anfälle
Anfang	Anfänge
Anfangsverdacht	Anfangsverdachte	Anfangsverdächte
Anflug	Anflüge
Anfänger	Anfänger
Anführer	Anführer
Angeber	Angeber
Angehörige	Angehörigen
Angelpunkt	Angelpunkte
Anger	Anger
Angler	Angler
Angreifer	Angreifer
Angriff	Angriffe
Angriffskrieg	Angriffskriege
Angstgegner	Angstgegner
Angsthase	Angsthasen
Anhaltspunkt	Anhaltspunkte
Anhang	Anhänge
Anhänger	Anhänger
Ankauf	Ankäufe
Anker	Anker
Anklagepunkt	Anklagepunkte
Anklang	Anklänge
Ankläger	Ankläger
Anlagenbau	—
Anlagenbauer	Anlagenbauer
Anlass	Anlässe
Anlauf	Anläufe
Anleger	Anleger
Anleihemarkt	Anleihemärkte
Anlieger	Anlieger
Anmarsch	—
Anmeldeschluss	Anmeldeschlüsse
Anorak	Anoraks
Anpfiff	Anpfiffe
Anrainer	Anrainer
Anreiz	Anreize
Anruf	Anrufe
Anrufbeantworter	Anrufbeantworter
Anrufer	Anrufer
Ansatz	Ansätze
Ansatzpunkt	Ansatzpunkte
Anschein	—
Anschlag	Anschläge
Anschluss	Anschlüsse
Anschlusstreffer	Anschlusstreffer
Ansporn	—
Ansprechpartner	Ansprechpartner
Anspruch	Ansprüche
Anstand	Anstände
Anstieg	Anstiege
Anstoß	Anstöße
Anstrich	Anstriche
Ansturm	Anstürme
Anteil	Anteile
Anteilseigner	Anteilseigner
Anthropologe	Anthropologen
Antifaschismus	—
Antifaschist	Antifaschisten
Antisemit	Antisemiten
Antisemitismus	Antisemitismen
Antrag	Anträge
Antragsteller	Antragsteller
Antrieb	Antriebe
Antritt	Antritte
Antrittsbesuch	Antrittsbesuche
Anwachs	—
Anwalt	Anwälte
Anwender	Anwender
Anwohner	Anwohner
Anwurf	Anwürfe
Anzeiger	Anzeiger
Anziehungspunkt	Anziehungspunkte
Anzug	Anzüge
Apfel	Äpfel
Apfelbaum	Apfelbäume
Apfelkuchen	Apfelkuchen
Apfelsaft	Apfelsäfte
Apfelwein	Apfelweine
Aphorismus	Aphorismen
Apostel	Apostel
Apotheker	Apotheker
Apparat	Apparate
Appeal	—
Appell	Appelle
Appetit	—
Applaus	Applause
April	Aprile
Ara	Aras
Araber	Araber
Arbeiter	Arbeiter
Arbeitgeber	Arbeitgeber
Arbeitgeberverband	Arbeitgeberverbände
Arbeitnehmer	Arbeitnehmer
Arbeitnehmervertreter	Arbeitnehmervertreter
Arbeitsablauf	Arbeitsabläufe
Arbeitsalltag	Arbeitsalltage
Arbeitsaufwand	Arbeitsaufwände
Arbeitsbereich	Arbeitsbereiche
Arbeitseinsatz	Arbeitseinsätze
Arbeitskampf	Arbeitskämpfe
Arbeitskollege	Arbeitskollegen
Arbeitskreis	Arbeitskreise
Arbeitsmarkt	Arbeitsmärkte
Arbeitsmarktservice	Arbeitsmarktservices
Arbeitsminister	Arbeitsminister
Arbeitsplatz	Arbeitsplätze
Arbeitsplatzabbau	—
Arbeitsplatzverlust	Arbeitsplatzverluste
Arbeitsprozess	Arbeitsprozesse
Arbeitsraum	Arbeitsräume
Arbeitsschutz	—
Arbeitstag	Arbeitstage
Arbeitstitel	Arbeitstitel
Arbeitsunfall	Arbeitsunfälle
Arbeitsvertrag	Arbeitsverträge
Archipel	Archipele
Architekt	Architekten
Architektenwettbewerb	Architektenwettbewerbe
Archivar	Archivare
Archäologe	Archäologen
Argentinier	Argentinier
Argwohn	—
Arm	Arme
Armeechef	Armeechefs
Armenier	Armenier
Arrest	Arreste
Arsch	Ärsche
Artenschutz	—
Artgenosse	Artgenossen
Artikel	Artikel
Artist	Artisten
Arzt	Ärzte
Arztbesuch	Arztbesuche
As	Asse
Asbest	Asbeste
Aschenbecher	Aschenbecher
Aschermittwoch	Aschermittwoche
Aspekt	Aspekte
Asphalt	Asphalte
Aspirant	Aspiranten
Assistent	Assistenten
Ast	Äste
Asteroid	Asteroiden
Astronaut	Astronauten
Astronom	Astronomen
Asylant	Asylanten
Asylantrag	Asylanträge
Asylbewerber	Asylbewerber
Atem	—
Atemzug	Atemzüge
Atheist	Atheisten
Athlet	Athleten
Atlantik	—
Atomausstieg	Atomausstiege
Atomkraftgegner	Atomkraftgegner
Atomkrieg	Atomkriege
Atommeiler	Atommeiler
Atomreaktor	Atomreaktoren
Atomstrom	—
Atomtest	Atomtests	Atomteste
Atomtransport	Atomtransporte
Atomversuch	Atomversuche
Atomwaffensperrvertrag	—
Attentäter	Attentäter
Attersee	—
Audit	Audits
Aufbau	Aufbaus
Aufbruch	Aufbrüche
Aufdruck	Aufdrucke
Aufenthalt	Aufenthalte
Aufenthaltsort	Aufenthaltsorte
Aufenthaltsraum	Aufenthaltsräume
Auffahrunfall	Auffahrunfälle
Aufgabenbereich	Aufgabenbereiche
Aufkleber	Aufkleber
Aufmarsch	Aufmärsche
Aufpasser	Aufpasser
Aufprall	Aufpralle
Aufpreis	Aufpreise
Aufruf	Aufrufe
Aufruhr	Aufruhre
Aufrührer	Aufrührer
Aufsatz	Aufsätze
Aufschlag	Aufschläge
Aufschluss	Aufschlüsse
Aufschrei	Aufschreis
Aufschub	Aufschübe
Aufschwung	Aufschwünge
Aufseher	Aufseher
Aufsichtsrat	Aufsichtsräte
Aufsichtsratschef	Aufsichtsratschefs
Aufstand	Aufstanden
Aufsteiger	Aufsteiger
Aufstieg	Aufstiege
Auftakt	Auftakte
Auftrag	Aufträge
Auftraggeber	Auftraggeber
Auftragsbestand	Auftragsbestände
Auftragseingang	Auftragseingänge
Auftrieb	Auftriebe
Auftritt	Auftritte
Aufwand	Aufwanden
Aufwind	Aufwinde
Aufzug	Aufzüge
Augenarzt	Augenärzte
Augenblick	Augenblicke
Augenschein	—
Augenzeuge	Augenzeugen
Augenzeugenbericht	Augenzeugenberichte
August	Auguste
Auktionator	Auktionatoren
Ausbau	Ausbauten	Ausbaue
Ausbauplan	Ausbaupläne
Ausbilder	Ausbilder
Ausbildungsberuf	Ausbildungsberufe
Ausbildungsbetrieb	Ausbildungsbetriebe
Ausbildungsplatz	Ausbildungsplätze
Ausblick	Ausblicke
Ausbruch	Ausbrüche
Ausdruck	Ausdrücke
Ausfall	Ausfälle
Ausflug	Ausflüge
Ausgabepreis	Ausgabepreise
Ausgang	Ausgänge
Ausgangspunkt	Ausgangspunkte
Ausgleich	Ausgleiche
Ausklang	Ausklänge
Auslandsaufenthalt	Auslandsaufenthalte
Auslandseinsatz	Auslandseinsätze
Auslauf	Ausläufe
Ausländer	Ausländer
Ausnahmefall	Ausnahmefälle
Ausnahmezustand	Ausnahmezustände
Auspuff	Auspuffe
Ausrichter	Ausrichter
Ausritt	Ausritte
Ausruf	Ausrufe
Ausrutscher	Ausrutscher
Ausschlag	Ausschläge
Ausschluss	Ausschlüsse
Ausschnitt	Ausschnitte
Ausschuss	Ausschüsse
Aussiedler	Aussiedler
Ausspruch	Aussprüche
Ausstand	Ausstände
Ausstatter	Ausstatter
Aussteiger	Aussteiger
Aussteller	Aussteller
Ausstellungsmacher	Ausstellungsmacher
Ausstellungsraum	Ausstellungsräume
Ausstieg	Ausstiege
Austausch	Austausche
Austragungsort	Austragungsorte
Austritt	Austritte
Ausverkauf	Ausverkäufe
Auswanderer	Auswanderer
Ausweg	Auswege
Ausweis	Ausweise
Auswuchs	Auswüchse
Auszug	Auszüge
Autobahnanschluss	Autobahnanschlüsse
Autobauer	Autobauer
Autobesitzer	Autobesitzer
Autobus	Autobusse
Autodidakt	Autodidakten
Autodieb	Autodiebe
Autodiebstahl	Autodiebstähle
Autofahrer	Autofahrer
Autohersteller	Autohersteller
Autoknacker	Autoknacker
Autokonzern	Autokonzerne
Autolenker	Autolenker
Automarkt	Automärkte
Automat	Automaten
Automatismus	Automatismen
Automobilhersteller	Automobilhersteller
Automobilist	Automobilisten
Automobilkonzern	Automobilkonzerne
Autor	Autoren
Autoreifen	Autoreifen
Autoschlüssel	Autoschlüssel
Autounfall	Autounfälle
Autoverkehr	—
Autozulieferer	Autozulieferer
Avantgardist	Avantgardisten
Azur	—
Babysitter	Babysitter
Bach	Bäche
Bachelor	Bachelors
Backen	Backen
Backofen	Backöfen
Backstein	Backsteine
Badeanzug	Badeanzüge
Badegast	Badegäste
Bademantel	Bademäntel
Bademeister	Bademeister
Badeort	Badeorte
Bader	Bader
Badesee	Badeseen
Bagger	Bagger
Bahnchef	Bahnchefs
Bahndamm	Bahndämme
Bahnhof	Bahnhöfe
Bahnhofsvorplatz	Bahnhofsvorplätze
Bahnsteig	Bahnsteige
Bahnverkehr	—
Balanceakt	Balanceakte
Balg	Bälge
Balkan	—
Balken	Balken
Balkon	Balkons	Balkone
Ball	Bälle
Ballast	Ballaste
Ballon	Ballons
Ballsaal	Ballsäle
Ballungsraum	Ballungsräume
Ballverlust	Ballverluste
Ballwechsel	Ballwechsel
Balsam	Balsame
Balte	Balten
Bandit	Banditen
Bandleader	Bandleader
Bankdirektor	Bankdirektoren
Bankensektor	Bankensektoren
Banker	Banker
Bankier	Bankiers
Bankkaufmann	Bankkaufmänner	Bankkaufleute
Bankkredit	Bankkredite
Bankkunde	Bankkunden
Bankomat	Bankomaten
Bankraub	Bankraube
Bankrott	Bankrotte
Bankräuber	Bankräuber
Banküberfall	Banküberfälle
Bann	Banne
Barbar	Barbaren
Barbier	Barbiere
Bariton	Baritone
Barkeeper	Barkeeper
Barock	—
Barometer	Barometer
Baron	Barone
Bart	Bärte
Basar	Basare
Baseball	Baseballs
Baseballschläger	Baseballschläger
Basispunkt	Basispunkte
Basistunnel	Basistunnels
Baske	Basken
Basketball	Basketbälle
Basketballer	Basketballer
Bass	Bässe
Bassist	Bassisten
Basso	Bassi
Bastard	Bastarde
Bastler	Bastler
Batzen	Batzen
Bau	Bauten	Baue
Bauabschnitt	Bauabschnitte
Bauantrag	Bauanträge
Bauarbeiter	Bauarbeiter
Bauausschuss	Bauausschüsse
Baubeginn	—
Bauboom	Baubooms
Bauch	Bäuche
Bauchschmerz	Bauchschmerzen
Baudezernent	Baudezernenten
Bauer	Bauern
Bauernhof	Bauernhöfe
Bauernverband	Bauernverbände
Baugrund	Baugründe
Bauherr	Bauherren
Bauhof	Bauhöfe
Bauingenieur	Bauingenieure
Baukonzern	Baukonzerne
Bauleiter	Bauleiter
Baum	Bäume
Baumarkt	Baumärkte
Baumbestand	Baumbestände
Baumeister	Baumeister
Baumgarten	Baumgärten
Bauminister	Bauminister
Baumstamm	Baumstämme
Bauplan	Baupläne
Bauplatz	Bauplätze
Bausch	Bausche	Bäusche
Bauschutt	—
Bausenator	Bausenatoren
Bausparvertrag	Bausparverträge
Baustein	Bausteine
Baustoff	Baustoffe
Baustopp	Baustopps
Bauunternehmer	Bauunternehmer
Bauwagen	Bauwagen	Bauwägen
Bauzaun	Bauzäune
Bayer	Bayern
Beach	Beaches
Beachvolleyball	Beachvolleybälle
Beamte	Beamten
Beamtenbund	Beamtenbünde
Beatle	Beatles
Bebauungsplan	Bebauungspläne
Becher	Becher
Bedacht	—
Bedarf	Bedarfe
Bedarfsfall	Bedarfsfälle
Befehl	Befehle
Befehlshaber	Befehlshaber
Befreier	Befreier
Befreiungsschlag	Befreiungsschläge
Befund	Befunde
Beginn	Beginne
Begleiter	Begleiter
Begriff	Begriffe
Behälter	Behälter
Beifahrer	Beifahrer
Beifahrersitz	Beifahrersitze
Beifall	—
Beigeschmack	Beigeschmäcke
Beiname	Beinamen
Beinbruch	Beinbrüche
Beirat	Beiräte
Beisitzer	Beisitzer
Beistand	Beistände
Beitrag	Beiträge
Beitragssatz	Beitragssätze
Beitragszahler	Beitragszahler
Beitritt	Beitritte
Beitrittskandidat	Beitrittskandidaten
Bekanntenkreis	Bekanntenkreise
Bekanntheitsgrad	Bekanntheitsgrade
Belag	Beläge
Belang	Belange
Beleg	Belege
Belgier	Belgier
Bengel	Bengel
Benutzer	Benutzer
Benziner	Benziner
Benzinmotor	Benzinmotoren
Benzinpreis	Benzinpreise
Beobachter	Beobachter
Berater	Berater
Berber	Berber
Bereich	Bereiche
Bereichsleiter	Bereichsleiter
Bereitschaftsdienst	Bereitschaftsdienste
Berg	Berge
Bergarbeiter	Bergarbeiter
Bergbau	—
Bergbauer	Bergbauern
Bergisel	—
Bergmann	Bergmänner
Bergsteiger	Bergsteiger
Bericht	Berichte
Berichterstatter	Berichterstatter
Beruf	Berufe
Berufskollege	Berufskollegen
Berufssoldat	Berufssoldaten
Berufsstand	Berufsstände
Berufsverband	Berufsverbände
Berufsverkehr	—
Besatzer	Besatzer
Bescheid	Bescheide
Beschlag	Beschläge
Beschluss	Beschlüsse
Beschuss	—
Beschützer	Beschützer
Besen	Besen
Besetzer	Besetzer
Besitz	Besitze
Besitzer	Besitzer
Besitzstand	Besitzstände
Bestand	Bestände
Bestandteil	Bestandteile
Bestseller	Bestseller
Besuch	Besuche
Besucher	Besucher
Besucherrekord	Besucherrekorde
Besucherstrom	Besucherströme
Beton	Betons	Betone
Betrachter	Betrachter
Betrag	Beträge
Betreff	Betreffe
Betreiber	Betreiber
Betreuer	Betreuer
Betrieb	Betriebe
Betriebsgewinn	Betriebsgewinne
Betriebsleiter	Betriebsleiter
Betriebsrat	Betriebsräte
Betriebsratschef	Betriebsratschefs
Betriebswirt	Betriebswirte
Betrug	Betrüge
Betrüger	Betrüger
Bettag	Bettage
Bettel	Bettel
Bettler	Bettler
Beutel	Beutel
Bewacher	Bewacher
Beweggrund	Beweggründe
Bewegungsablauf	Bewegungsabläufe
Beweis	Beweise
Bewerber	Bewerber
Bewohner	Bewohner
Bewunderer	Bewunderer
Bewährungshelfer	Bewährungshelfer
Bezieher	Bezieher
Bezirk	Bezirke
Bezirksanwalt	Bezirksanwälte
Bezirksausschuss	Bezirksausschüsse
Bezirkschef	Bezirkschefs
Bezirkshauptmann	Bezirkshauptmänner	Bezirkshauptleute
Bezirksleiter	Bezirksleiter
Bezirksrat	Bezirksräte
Bezirksverband	Bezirksverbände
Bezirksvorsteher	Bezirksvorsteher
Bezug	Bezüge
Bezugspunkt	Bezugspunkte
Bezwinger	Bezwinger
Biathlet	Biathleten
Biathlon	Biathlons
Bibi	Bibis
Bibliothekar	Bibliothekare
Biedermann	Biedermänner
Biergarten	Biergärten
Bieter	Bieter
Biker	Biker
Bikini	Bikinis
Bilanzgewinn	Bilanzgewinne
Bildband	Bildbände
Bildhauer	Bildhauer
Bildschirm	Bildschirme
Bildungsminister	Bildungsminister
Bildungspolitiker	Bildungspolitiker
Bildungsurlaub	Bildungsurlaube
Bildungsweg	Bildungswege
Billigflieger	Billigflieger
Binder	Binder
Binnenmarkt	Binnenmärkte
Biobauer	Biobauern
Biodiesel	—
Biologe	Biologen
Biotop	Biotope
Birnbaum	Birnbäume
Bischof	Bischöfe
Biss	Bisse
Bissen	Bissen
Bittsteller	Bittsteller
Blackout	Blackouts
Blauhelm	Blauhelme
Blazer	Blazer
Blechschaden	Blechschäden
Bleistift	Bleistifte
Blick	Blicke
Blickfang	Blickfänge
Blickpunkt	Blickpunkte
Blickwinkel	Blickwinkel
Blindgänger	Blindgänger
Blitz	Blitze
Blitzschlag	Blitzschläge
Blizzard	Blizzards
Blocher	Blochers	Blocher
Block	Blöcke
Blues	Blues
Bluff	Bluffs
Blumenschmuck	Blumenschmucke
Blumentopf	Blumentöpfe
Blutdruck	Blutdrücke	Blutdrucke
Bluterguss	Blutergüsse
Bluthochdruck	—
Bluttest	Bluttests	Blutteste
Bobby	Bobbys
Bock	Böcke
Boden	Böden
Bodenbelag	Bodenbeläge
Bodensee	—
Body	Bodys
Bogen	Bogen	Bögen
Bohrer	Bohrer
Bolid	Boliden
Bolzplatz	Bolzplätze
Bombenangriff	Bombenangriffe
Bombenanschlag	Bombenanschläge
Bombenleger	Bombenleger
Bomber	Bomber
Bon	Bons
Bonbon	Bonbons
Bond	Bonds
Bonus	Bonus	Bonusse	Boni
Boom	Booms
Bordcomputer	Bordcomputer
Born	Borne
Bosnier	Bosnier
Bosporus	—
Boss	Bosse
Botaniker	Botaniker
Bote	Boten
Botenstoff	Botenstoffe
Botschafter	Botschafter
Boulevard	Boulevards
Boxenstopp	Boxenstopps
Boxer	Boxer
Boxkampf	Boxkämpfe
Boy	Boys
Boykott	Boykotts	Boykotte
Branchenprimus	Branchenprimusse	Branchenprimi
Brand	Branden
Brandanschlag	Brandanschläge
Brandherd	Brandherde
Brandsatz	Brandsätze
Brandschutz	—
Brandstifter	Brandstifter
Brasilianer	Brasilianer
Braten	Braten
Brauch	Bräuche
Brauer	Brauer
Brei	Breis
Breisgau	—
Breitengrad	Breitengrade
Breitensport	—
Bremser	Bremser
Brenner	Brenner
Brennpunkt	Brennpunkte
Brennstab	Brennstäbe
Brennstoff	Brennstoffe
Brie	Bries
Brief	Briefe
Briefkasten	Briefkästen
Briefwechsel	Briefwechsel
Brink	Brinke
Brite	Briten
Brocken	Brocken
Broker	Broker
Browser	Browser
Bruch	Brüche
Bruchteil	Bruchteile
Bruder	Brüder
Brunch	Brunchs
Brunnen	Brunnen
Brustkorb	Brustkörbe
Brustkrebs	Brustkrebse
Bruttolohn	Bruttolöhne
Bräutigam	Bräutigame
Bub	Buben
Bube	Buben
Bubi	Bubis
Buchautor	Buchautoren
Buchenwald	Buchenwälder
Buchhalter	Buchhalter
Buchhandel	—
Buchladen	Buchläden
Buchmacher	Buchmacher
Buchmarkt	Buchmärkte
Buchs	Buchse
Buchstabe	Buchstaben
Buchtitel	Buchtitel
Buchverlag	Buchverlage
Buckel	Buckel
Buddhismus	—
Buddhist	Buddhisten
Bug	Buge
Buhmann	Buhmänner
Buhruf	Buhrufe
Bulgare	Bulgaren
Bulldozer	Bulldozer
Bulle	Bullen
Bumerang	Bumerangs	Bumerange
Bund	Bünde
Bundesanwalt	Bundesanwälte
Bundesarbeitsminister	Bundesarbeitsminister
Bundesdurchschnitt	—
Bundesfinanzhof	—
Bundesfinanzminister	Bundesfinanzminister
Bundesgerichtshof	—
Bundesgesundheitsminister	Bundesgesundheitsminister
Bundesgrenzschutz	—
Bundeshaushalt	Bundeshaushalte
Bundesinnenminister	Bundesinnenminister
Bundeskanzler	Bundeskanzler
Bundesligaklub	Bundesligaklubs
Bundesligist	Bundesligisten
Bundesminister	Bundesminister
Bundesnachrichtendienst	—
Bundesparteitag	Bundesparteitage
Bundesrat	Bundesräte
Bundesrechnungshof	—
Bundessprecher	Bundessprecher
Bundesstaat	Bundesstaaten
Bundestag	Bundestage
Bundestagswahlkampf	Bundestagswahlkämpfe
Bundestrainer	Bundestrainer
Bundesumweltminister	Bundesumweltminister
Bundesverkehrsminister	Bundesverkehrsminister
Bundesverteidigungsminister	Bundesverteidigungsminister
Bundesvorstand	Bundesvorstände
Bundeswehreinsatz	Bundeswehreinsätze
Bundeswehrsoldat	Bundeswehrsoldaten
Bundeswirtschaftsminister	Bundeswirtschaftsminister
Bungalow	Bungalows
Bunker	Bunker
Bursch	Burschen
Bursche	Burschen
Bus	Busse
Busbahnhof	Busbahnhöfe
Busen	Busen
Busfahrer	Busfahrer
Butler	Butler
Butt	Butt	Butte
Butterfly	Butterflys
Button	Buttons
Bypass	Bypässe
Bäcker	Bäcker
Bär	Bären
Börsenmakler	Börsenmakler
Büffel	Büffel
Bügel	Bügel
Bürger	Bürger
Bürgersteig	Bürgersteige
Bürokrat	Bürokraten
Camper	Camper
Camping	—
Campingplatz	Campingplätze
Campus	Campus
Cannabis	—
Canyon	Canyons
Caravan	Caravans
Carrier	Carriers
Cartoon	Cartoons
Casanova	Casanovas
Cellist	Cellisten
Cent	Centen
Chairman	Chairmen
Champagner	Champagner
Champion	Champions
Chaot	Chaoten
Charakter	Charaktere
Charme	—
Chart	Charts
Charter	Charters
Chat	Chats
Chauffeur	Chauffeure
Checkpoint	Checkpoints
Cheerleader	Cheerleader
Chef	Chefs
Chefarzt	Chefärzte
Chefcoach	Chefcoachs	Chefcoaches
Chefdirigent	Chefdirigenten
Chefposten	Chefposten
Chefredakteur	Chefredakteure
Chefredaktor	Chefredaktoren
Chefsessel	Chefsessel
Cheftrainer	Cheftrainer
Chemiekonzern	Chemiekonzerne
Chemiker	Chemiker
Chief	Chiefs
Chiemsee	—
Chilene	Chilenen
Chili	Chilis
Chinese	Chinesen
Chip	Chips
Chiphersteller	Chiphersteller
Chirurg	Chirurgen
Chor	Chore
Choral	Choräle
Chorgesang	Chorgesänge
Chorherr	Chorherren
Chorleiter	Chorleiter
Christ	Christen
Christbaum	Christbäume
Christdemokrat	Christdemokraten
Christkindlmarkt	Christkindlmärkte
Chronist	Chronisten
Cineast	Cineasten
Claim	Claims
Clan	Clane	Clans
Clinch	—
Clou	Clous
Clown	Clowns
Cocktail	Cocktails
Code	Coden
Colt	Colts
Comic	Comics
Computer	Computer
Computerhersteller	Computerhersteller
Computerkonzern	Computerkonzerne
Container	Container
Contest	Contests
Controller	Controller
Cop	Cops
Cord	Cords
Corner	Corners
Couch	Couches
Countdown	Countdowns
Coup	Coups
Coupon	Coupons
Court	Courts
Cousin	Cousins
Cowboy	Cowboys
Cox	Cox
Crash	Crashs	Crashes
Creek	Creek
Cup	Cups
Cupsieger	Cupsieger
Curry	Currys
Cut	Cuts
Cyberspace	Cyberspaces
Dachboden	Dachböden
Dachdecker	Dachdecker
Dachs	Dachse
Dachstuhl	Dachstühle
Dachverband	Dachverbände
Dackel	Dackel
Dada	—
Dagestan	Dagestan
Damian	Damians
Damm	Dämme
Dampf	Dämpfe
Dampfer	Dampfer
Dan	Dan
Dancefloor	Dancefloors
Dandy	Dandys
Dank	—
Darling	Darlings	Darlinge
Darm	Därme
Darsteller	Darsteller
Datenaustausch	Datenaustausche
Datenschutz	—
Dauerbrenner	Dauerbrenner
Dauereinsatz	Dauereinsätze
Dauerregen	Dauerregen
Daumen	Daumen
Deal	Deals
Dealer	Dealer
Dechant	Dechanten
Deckel	Deckel
Deckmantel	Deckmäntel
Deckname	Decknamen
Decoder	Decoder
Defekt	Defekte
Deich	Deiche
Dekan	Dekane
Dekor	Dekore	Dekors
Delegationsleiter	Delegationsleiter
Delinquent	Delinquenten
Delphin	Delphine
Demokrat	Demokraten
Demonstrant	Demonstranten
Demonstrationszug	Demonstrationszüge
Demos	Demen
Denker	Denker
Denkmalpfleger	Denkmalpfleger
Denkmalschutz	—
Denkzettel	Denkzettel
Depp	Deppen
Deserteur	Deserteure
Designer	Designer
Desktop	Desktops
Despot	Despoten
Detektiv	Detektive
Detektor	Detektoren
Deutschlandfunk	—
Deutschschweizer	Deutschschweizer
Deutschunterricht	—
Devisenmarkt	Devisenmärkte
Dezember	Dezember
Dezernent	Dezernenten
Diabetes	—
Diabetiker	Diabetiker
Diakon	Diakonen	Diakone
Dialekt	Dialekte
Dialog	Dialoge
Diavortrag	Diavorträge
Dichter	Dichter
Dieb	Diebe
Diebstahl	Diebstähle
Diener	Diener
Dienst	Dienste
Dienstag	Dienstage
Dienstagabend	Dienstagabende
Dienstagmorgen	Dienstagmorgen
Dienstagnachmittag	Dienstagnachmittage
Dienstgeber	Dienstgeber
Dienstherr	Dienstherren
Dienstleister	Dienstleister
Dienstleistungsbereich	Dienstleistungsbereiche
Dienstleistungsbetrieb	Dienstleistungsbetriebe
Dienstleistungssektor	Dienstleistungssektoren
Dienstnehmer	Dienstnehmer
Dienstposten	Dienstposten
Dienstwagen	Dienstwagen	Dienstwägen
Diesel	Diesel
Dieselmotor	Dieselmotoren
Diktator	Diktatoren
Dilettantismus	Dilettantismen
Dill	Dille
Dinar	Dinare
Ding	Dinge
Dings	Dings
Dino	Dinos
Dinosaurier	Dinosaurier
Diplomat	Diplomaten
Direkteinspritzer	Direkteinspritzer
Direktkandidat	Direktkandidaten
Direktor	Direktoren
Dirigent	Dirigenten
Discount	Discounts
Diskont	Diskonte	Diskonten
Diskontsatz	Diskontsätze
Diskurs	Diskurse
Diskus	Diskusse	Disken
Disput	Dispute
Dissens	Dissense
Dissident	Dissidenten
Distrikt	Distrikte
Doktor	Doktoren
Doktorand	Doktoranden
Doktortitel	Doktortitel
Dokumentarfilm	Dokumentarfilme
Dokumentarfilmer	Dokumentarfilmer
Dolch	Dolche
Dollar	Dollar	Dollars
Dollarkurs	Dollarkurse
Dolmetscher	Dolmetscher
Dolomit	Dolomite
Domplatz	Domplätze
Donner	Donner
Donnerstag	Donnerstage
Donnerstagabend	Donnerstagabende
Donnerstagmorgen	Donnerstagmorgen
Donnerstagnachmittag	Donnerstagnachmittage
Dopingfall	Dopingfälle
Doppeldecker	Doppeldecker
Doppelhaushalt	Doppelhaushalte
Doppelmord	Doppelmorde
Doppelpack	Doppelpacks
Doppelpass	Doppelpässe
Doppelschlag	Doppelschläge
Doppelsieg	Doppelsiege
Doppelzweier	Doppelzweier
Dorfbewohner	Dorfbewohner
Dorfplatz	Dorfplätze
Dorn	Dornen	Dörner	Dorne
Dornbusch	Dornbüsche
Download	Downloads
Dozent	Dozenten
Drache	Drachen
Drachen	Drachen
Draht	Drähte
Drahtesel	Drahtesel
Drahtzieher	Drahtzieher
Dramatiker	Dramatiker
Dramaturg	Dramaturgen
Drang	Dränge
Drechsler	Drechsler
Dreck	Drecke
Dreh	Drehs	Drehe
Drehbuchautor	Drehbuchautoren
Dreher	Dreher
Drehort	Drehorte
Dreikampf	Dreikämpfe
Dringlichkeitsantrag	Dringlichkeitsanträge
Drink	Drinks
Drittel	Drittel
Drittstaat	Drittstaaten
Drogendealer	Drogendealer
Drogenfahnder	Drogenfahnder
Drogenhandel	Drogenhandel
Drogenkonsum	—
Drogenmissbrauch	Drogenmissbräuche
Drohbrief	Drohbriefe
Drost	Droste
Drucker	Drucker
Dschihad	—
Dschungel	Dschungel	Dschungeln	Dschungels
Dual	Duale
Duft	Düfte
Duke	Dukes
Duktus	—
Dumpingpreis	Dumpingpreise
Dunst	Dünste
Dunstkreis	Dunstkreise
Durchblick	Durchblicke
Durchbruch	Durchbrüche
Durchfall	Durchfälle
Durchgang	Durchgänge
Durchgangsverkehr	—
Durchmarsch	Durchmärsche
Durchmesser	Durchmesser
Durchschnitt	Durchschnitte
Durchschnittspreis	Durchschnittspreise
Durchschnittswert	Durchschnittswerte
Durchsuchungsbefehl	Durchsuchungsbefehle
Durst	—
Dynamo	Dynamos
Dämon	Dämonen
Dämpfer	Dämpfer
Däne	Dänen
Dünger	Dünger
Eagle	Eagles	Eagles
Eckball	Eckbälle
Eckpfeiler	Eckpfeiler
Eckpunkt	Eckpunkte
Eckstein	Ecksteine
Edelmann	Edelmänner	Edelleute
Edelstahl	Edelstähle	Edelstahle
Edelstein	Edelsteine
Effekt	Effekte
Egli	Essi
Egoismus	Egoismen
Ehebruch	Ehebrüche
Ehegatte	Ehegatten
Ehemann	Ehemänner
Ehepartner	Ehepartner
Ehrengast	Ehrengäste
Ehrenplatz	Ehrenplätze
Ehrentitel	Ehrentitel
Ehrgeiz	—
Eicher	Eicher
Eid	Eide
Eidgenosse	Eidgenossen
Eifer	Eifer
Eigenbedarf	—
Eigenbetrieb	Eigenbetriebe
Eigensinn	—
Eigner	Eigner
Eilantrag	Eilanträge
Eimer	Eimer
Einakter	Einakter
Einbau	Einbauten
Einbezug	—
Einblick	Einblicke
Einbrecher	Einbrecher
Einbruch	Einbrüche
Eindringling	Eindringlinge
Eindruck	Eindrücke
Einer	Einer
Einfall	Einfälle
Einfallsreichtum	—
Einfluss	Einflüsse
Einflussbereich	Einflussbereiche
Eingang	Eingänge
Eingangsbereich	Eingangsbereiche
Eingriff	Eingriffe
Einhalt	—
Einigungsprozess	Einigungsprozesse
Einigungsvertrag	Einigungsverträge
Einkauf	Einkäufe
Einkaufsbummel	Einkaufsbummel
Einkaufsmarkt	Einkaufsmärkte
Einkaufswagen	Einkaufswagen	Einkaufswägen
Einklang	Einklänge
Einkommensverlust	Einkommensverluste
Einlass	Einlässe
Einmarsch	Einmärsche
Einnahmeausfall	Einnahmeausfälle
Einsatz	Einsätze
Einsatzleiter	Einsatzleiter
Einsatzort	Einsatzorte
Einschlag	Einschläge
Einschluss	Einschlüsse
Einschnitt	Einschnitte
Einsender	Einsender
Einsendeschluss	Einsendeschlüsse
Einspruch	Einsprüche
Einstand	Einstände
Einsteiger	Einsteiger
Einstieg	Einstiege
Einsturz	Einstürze
Eintopf	Eintöpfe
Eintrag	Einträge
Eintritt	Eintritte
Eintrittspreis	Eintrittspreise
Einwand	Einwanden
Einwanderer	Einwanderer
Einwohner	Einwohner
Einwurf	Einwürfe
Einzelfall	Einzelfälle
Einzelgänger	Einzelgänger
Einzelhandel	—
Einzelhandelsverband	Einzelhandelsverbände
Einzelrichter	Einzelrichter
Einzug	Einzüge
Einzugsbereich	Einzugsbereiche
Eisberg	Eisberge
Eisbär	Eisbären
Eisenbahner	Eisenbahner
Eisenring	Eisenringe
Eishockeyspieler	Eishockeyspieler
Eiskunstlauf	—
Eislauf	—
Eistee	Eisteen
Eiswürfel	Eiswürfel
Ekel	—
Eklat	Eklats
Elan	—
Elch	Elche
Elefant	Elefanten
Elektriker	Elektriker
Elektromotor	Elektromotoren
Elektronikkonzern	Elektronikkonzerne
Elektrosmog	—
Eleve	Eleven
Elfenbeinturm	Elfenbeintürme
Elfer	Elfer
Elferrat	Elferräte
Elfmeter	Elfmeter
Ellbogen	Ellbogen
Ellenbogen	Ellenbogen
Elternbeirat	Elternbeiräte
Elternteil	Elternteile
Elternverein	Elternvereine
Embryo	Embryonen	Embryos
Emigrant	Emigranten
Emir	Emire
Emittent	Emittenten
Empfang	Empfänge
Empfänger	Empfänger
Endeffekt	Endeffekte
Endkampf	Endkämpfe
Endlauf	Endläufe
Endpunkt	Endpunkte
Endspurt	Endspurts	Endspurte
Endstand	Endstände
Endverbraucher	Endverbraucher
Energiebedarf	Energiebedarfe
Energiekonzern	Energiekonzerne
Energiemarkt	Energiemärkte
Energiepreis	Energiepreise
Energieverbrauch	Energieverbräuche
Energieversorger	Energieversorger
Engel	Engel
Engländer	Engländer
Engpass	Engpässe
Entdecker	Entdecker
Entertainer	Entertainer
Enthusiasmus	—
Enthusiast	Enthusiasten
Entscheid	Entscheide
Entscheidungsprozess	Entscheidungsprozesse
Entschluss	Entschlüsse
Entsorger	Entsorger
Entwickler	Entwickler
Entwicklungshelfer	Entwicklungshelfer
Entwurf	Entwürfe
Entzug	Entzüge
Erbauer	Erbauer
Erdapfel	Erdäpfel
Erdball	—
Erdboden	Erdböden
Erdrutsch	Erdrutsche
Erdteil	Erdteile
Erfahrungsaustausch	Erfahrungsaustausche
Erfahrungsbericht	Erfahrungsberichte
Erfahrungswert	Erfahrungswerte
Erfinder	Erfinder
Erfolg	Erfolge
Erfolgsdruck	—
Erfolgskurs	Erfolgskurse
Erhalt	—
Erlass	Erlasse	Erlässe
Erlebnispark	Erlebnisparks
Erlöser	Erlöser
Ermittler	Ermittler
Ermittlungsrichter	Ermittlungsrichter
Erneuerer	Erneuerer
Ernstfall	Ernstfälle
Eroberer	Eroberer
Erpresser	Erpresser
Erreger	Erreger
Ersatz	Ersätze
Ersatzmann	Ersatzmänner
Ersatzteil	Ersatzteile
Erstligist	Erstligisten
Erstling	Erstlinge
Ertrag	Erträge
Erweiterungsbau	Erweiterungsbauten
Erwerb	Erwerbe
Erwerber	Erwerber
Erzbischof	Erzbischöfe
Erzeuger	Erzeuger
Erzeugerpreis	Erzeugerpreise
Erzfeind	Erzfeinde
Erzherzog	Erzherzoge	Erzherzöge
Erzieher	Erzieher
Erziehungsurlaub	Erziehungsurlaube
Erzrivale	Erzrivalen
Erzähler	Erzähler
Esel	Esel
Esprit	—
Essay	Essays
Essayist	Essayisten
Esser	Esser
Essig	Essige
Este	Esten
Etappensieg	Etappensiege
Etat	Etats
Etatentwurf	Etatentwürfe
Ethnologe	Ethnologen
Etikettenschwindel	Etikettenschwindel
Etter	Etter
Eurofighter	Eurofighter
Europacup	Europacups
Europameister	Europameister
Europapokal	Europapokale
Europarat	—
Eurotunnel	—
Evangelist	Evangelisten
Event	Events
Evergreen	Evergreens
Ex	Ex	Ex
Exhibitionist	Exhibitionisten
Exkurs	Exkurse
Exodus	Exodusse
Exote	Exoten
Experte	Experten
Exponent	Exponenten
Exporteur	Exporteure
Express	Expresse
Expressionismus	—
Expressionist	Expressionisten
Extrakt	Extrakte
Extremfall	Extremfälle
Extremismus	Extremismen
Extremist	Extremisten
Exzess	Exzesse
Faber	Fabri
Fabrikant	Fabrikanten
Facharbeiter	Facharbeiter
Facharzt	Fachärzte
Fachausschuss	Fachausschüsse
Fachbereich	Fachbereiche
Fachbesucher	Fachbesucher
Fachhandel	—
Fachjargon	Fachjargons
Fachkreis	Fachkreise
Fachmann	Fachleute
Fachmarkt	Fachmärkte
Fachverband	Fachverbände
Faden	Fäden	Faden
Fahnder	Fahnder
Fahrbahnrand	Fahrbahnränder
Fahrdienst	Fahrdienste
Fahrer	Fahrer
Fahrgast	Fahrgäste
Fahrlehrer	Fahrlehrer
Fahrplan	Fahrpläne
Fahrplanwechsel	Fahrplanwechsel
Fahrpreis	Fahrpreise
Fahrradfahrer	Fahrradfahrer
Fahrschein	Fahrscheine
Fahrstreifen	Fahrstreifen
Fahrstuhl	Fahrstühle
Fahrzeuglenker	Fahrzeuglenker
Fakt	Fakten	Fakts
Faktor	Faktoren
Falke	Falken
Falkner	Falkner
Fall	Fälle
Fallschirm	Fallschirme
Fallschirmjäger	Fallschirmjäger
Fallschirmspringer	Fallschirmspringer
Falter	Falter
Familienbesitz	Familienbesitze
Familienbetrieb	Familienbetriebe
Familiengottesdienst	Familiengottesdienste
Familienkreis	Familienkreise
Familienminister	Familienminister
Familienname	Familiennamen
Familientag	Familientage
Familienvater	Familienväter
Familienverband	Familienverbände
Fan	Fans
Fanatiker	Fanatiker
Fanatismus	—
Fang	Fänge
Farbstoff	Farbstoffe
Farbton	Farbtöne
Farbtupfer	Farbtupfer
Farmer	Farmer
Fasching	Faschings	Faschinge
Faschismus	—
Faschist	Faschisten
Faulpelz	Faulpelze
Faustball	Faustbälle
Faustschlag	Faustschläge
Favorit	Favoriten
Fax	Faxe
Februar	Februare
Fechter	Fechter
Fehlalarm	Fehlalarme
Fehlbetrag	Fehlbeträge
Fehler	Fehler
Fehlpass	Fehlpässe
Fehlschlag	Fehlschläge
Fehlstart	Fehlstarts	Fehlstarte
Fehltritt	Fehltritte
Feierabend	Feierabende
Feiertag	Feiertage
Feigling	Feiglinge
Feind	Feinde
Feinschmecker	Feinschmecker
Feinstaub	Feinstäube
Feldherr	Feldherren
Feldspieler	Feldspieler
Feldweg	Feldwege
Feldzug	Feldzüge
Felsbrocken	Felsbrocken
Felsen	Felsen
Feminismus	Feminismen
Fensterheber	Fensterheber
Feriengast	Feriengäste
Ferienort	Ferienorte
Ferner	Ferner
Fernfahrer	Fernfahrer
Fernsehapparat	Fernsehapparate
Fernsehauftritt	Fernsehauftritte
Fernseher	Fernseher
Fernsehfilm	Fernsehfilme
Fernsehkanal	Fernsehkanäle
Fernsehschirm	Fernsehschirme
Fernsehsender	Fernsehsender
Fernsehturm	Fernsehtürme
Fernsehzuschauer	Fernsehzuschauer
Fernverkehr	Fernverkehre
Festakt	Festakte
Festgast	Festgäste
Festgottesdienst	Festgottesdienste
Festplatz	Festplätze
Festredner	Festredner
Festsaal	Festsäle
Festtag	Festtage
Festumzug	Festumzüge
Festzug	Festzüge
Fetisch	Fetische
Fetzen	Fetzen
Feuerbrand	Feuerbrände
Feuerstein	Feuersteine
Feuerwehrkommandant	Feuerwehrkommandanten
Feuerwehrmann	Feuerwehrleute
Fiedler	Fiedler
Figaro	Figaros
Fighter	Fighters
File	Files
Filialleiter	Filialleiter
Film	Filme
Filmemacher	Filmemacher
Filmer	Filmer
Filmpreis	Filmpreise
Filmproduzent	Filmproduzenten
Filmregisseur	Filmregisseure
Filmstar	Filmstars
Filter	Filter
Filz	Filze
Finaleinzug	Finaleinzüge
Finalist	Finalisten
Finalsieg	Finalsiege
Finanzausgleich	Finanzausgleiche
Finanzausschuss	Finanzausschüsse
Finanzbedarf	Finanzbedarfe
Finanzchef	Finanzchefs
Finanzdienstleister	Finanzdienstleister
Finanzdirektor	Finanzdirektoren
Finanzexperte	Finanzexperten
Finanzier	Finanziers
Finanzinvestor	Finanzinvestoren
Finanzmarkt	Finanzmärkte
Finanzminister	Finanzminister
Finanzplan	Finanzpläne
Finanzplatz	Finanzplätze
Finanzsektor	Finanzsektoren
Finanzsenator	Finanzsenatoren
Finanzvorstand	Finanzvorstände
Finder	Finder
Finger	Finger
Fingerabdruck	Fingerabdrücke
Fingernagel	Fingernägel
Fingerzeig	Fingerzeige
Fink	Finken
Finke	Finken
Firmenchef	Firmenchefs
Firmenkunde	Firmenkunden
Firmenname	Firmennamen
Firmensitz	Firmensitze
Firmensprecher	Firmensprecher
First	Firste
Fisch	Fische
Fischer	Fischer
Fischfang	Fischfänge
Fischmarkt	Fischmärkte
Fiskus	Fisken	Fiskusse
Fittich	Fittiche
Fitz	FitzdieFitzes	Fitzens
Fixpunkt	Fixpunkte
Fjord	Fjorde
Flair	—
Flamenco	Flamencos
Flammenwerfer	Flammenwerfer
Flaneur	Flaneure
Flash	Flashs
Fleck	Flecke
Flegel	Flegel
Fleischer	Fleischer
Flieger	Flieger
Flipper	Flipper
Flirt	Flirts
Flitzer	Flitzer
Floh	Flöhe
Flohmarkt	Flohmärkte
Flop	Flops
Fluch	Flüche
Fluchtversuch	Fluchtversuche
Fluchtweg	Fluchtwege
Flug	Flüge
Flugbetrieb	Flugbetriebe
Fluggast	Fluggäste
Flughafen	Flughäfen
Fluglotse	Fluglotsen
Flugplan	Flugpläne
Flugplatz	Flugplätze
Flugverkehr	—
Flugzeugabsturz	Flugzeugabstürze
Flugzeugbau	—
Flugzeughersteller	Flugzeughersteller
Fluss	Flüsse
Flyer	Flyer
Flüchtling	Flüchtlinge
Flügel	Flügel
Fokus	Fokusse
Folgeschaden	Folgeschäden
Folk	Folks
Fond	Fonds
Fonds	Fonds
Fondsmanager	Fondsmanager
Football	Footballs
Forderungskatalog	Forderungskataloge
Forint	Forints
Formfehler	Formfehler
Forscher	Forscher
Forschungsreaktor	Forschungsreaktoren
Forst	Forste	Forsten
Fortbestand	—
Fortgang	Fortgänge
Fortschritt	Fortschritte
Fotoapparat	Fotoapparate
Fotograf	Fotografen
Fototermin	Fototermine
Foulelfmeter	Foulelfmeter
Frachter	Frachter
Frack	Fräcke
Fragebogen	Fragebogen
Fraktionschef	Fraktionschefs
Fraktionskollege	Fraktionskollegen
Fraktionssprecher	Fraktionssprecher
Fraktionsvorsitz	Fraktionsvorsitze
Fraktionsvorstand	Fraktionsvorstände
Franc	Francs
Franke	Franken
Franziskaner	Franziskaner
Franzose	Franzosen
Frauenanteil	Frauenanteile
Frauenarzt	Frauenärzte
Frauenchor	Frauenchöre
Frauentag	Frauentage
Frauenverein	Frauenvereine
Freak	Freaks
Freestyle	Freestyles
Freiberufler	Freiberufler
Freibetrag	Freibeträge
Freibrief	Freibriefe
Freidemokrat	Freidemokraten
Freigang	Freigänge
Freihandel	—
Freiheitsentzug	—
Freiherr	Freiherren
Freiraum	Freiräume
Freispruch	Freisprüche
Freistaat	Freistaaten
Freistil	—
Freitag	Freitage
Freitagabend	Freitagabende
Freitagmorgen	Freitagmorgen
Freitagnachmittag	Freitagnachmittage
Freitod	Freitode
Freizeitpark	Freizeitparks	Freizeitparke	Freizeitpärke
Fremdenhass	—
Fremdenverkehr	Fremdenverkehre
Freund	Freunde
Freundeskreis	Freundeskreise
Friede	Frieden
Frieden	Frieden
Friedensnobelpreis	Friedensnobelpreise
Friedensplan	Friedenspläne
Friedenspreis	Friedenspreise
Friedensprozess	Friedensprozesse
Friedensschluss	Friedensschlüsse
Friedensvertrag	Friedensverträge
Friedhof	Friedhöfe
Friese	Friesen
Friseur	Friseure
Frohsinn	—
Frontmann	Frontmänner	Frontleute
Frosch	Frösche
Frost	Fröste
Fruchtsaft	Fruchtsäfte
Frust	Fruste
Frühling	Frühlinge
Fuchs	Füchse
Fuhrmann	Fuhrleute	Fuhrmänner
Fuhrpark	Fuhrparks	Fuhrparke	Fuhrpärke
Fund	Funde
Fundamentalismus	Fundamentalismen
Fundamentalist	Fundamentalisten
Fundort	Fundorte
Fundus	—
Funke	Funken
Funken	Funken
Funkkontakt	Funkkontakte
Funkspruch	Funksprüche
Funkturm	Funktürme
Fuß	Füße
Fußabdruck	Fußabdrücke
Fähnrich	Fähnriche
Fänger	Fänger
Föhn	Föhne
Führer	Führer
Führerschein	Führerscheine
Füller	Füller
Gabler	Gabler
Gag	Gags
Galerist	Galeristen
Galgen	Galgen
Galopp	Galopps	Galoppe
Gams	GamsdieGamsen
Gang	Gänge
Gangster	Gangster
Ganove	Ganoven
Garant	Garanten
Garaus	Garaus
Gardasee	—
Garten	Gärten
Gartenbau	—
Gartenfreund	Gartenfreunde
Gartenzaun	Gartenzäune
Gartenzwerg	Gartenzwerge
Gaspreis	Gaspreise
Gast	Gäste
Gastarbeiter	Gastarbeiter
Gastgeber	Gastgeber
Gasthof	Gasthöfe
Gastkommentar	Gastkommentare
Gastronom	Gastronomen
Gastronomiebetrieb	Gastronomiebetriebe
Gastwirt	Gastwirte
Gatte	Gatten
Gau	Gaue
Gaukler	Gaukler
Gaul	Gäule
Gaullist	Gaullisten
Gault	Gaults
Gaumen	Gaumen
Gauner	Gauner
Gebauer	Gebauer
Geber	Geber
Gebieter	Gebieter
Gebrauch	Gebräuche
Gebrauchsgegenstand	Gebrauchsgegenstände
Gebrauchtwagen	Gebrauchtwagen
Geburtsort	Geburtsorte
Geburtstag	Geburtstage
Gedanke	Gedanken
Gedankenaustausch	Gedankenaustausche
Gedankengang	Gedankengänge
Gedenkstein	Gedenksteine
Gedenktag	Gedenktage
Gedichtband	Gedichtbände
Gedächtnisverlust	Gedächtnisverluste
Gefallen	Gefallen
Gefrierpunkt	Gefrierpunkte
Gefährte	Gefährten
Gegenangriff	Gegenangriffe
Gegendemonstrant	Gegendemonstranten
Gegenentwurf	Gegenentwürfe
Gegenkandidat	Gegenkandidaten
Gegenpol	Gegenpole
Gegensatz	Gegensätze
Gegenschlag	Gegenschläge
Gegenspieler	Gegenspieler
Gegenstand	Gegenstanden
Gegentreffer	Gegentreffer
Gegenverkehr	—
Gegenvorschlag	Gegenvorschläge
Gegenwert	Gegenwerte
Gegenwind	—
Gegenzug	Gegenzüge
Gegner	Gegner
Gehalt	Gehalte
Geheimagent	Geheimagenten
Geheimdienst	Geheimdienste
Geheimdienstchef	Geheimdienstchefs
Geheimdienstler	Geheimdienstler
Geheimtipp	Geheimtipps
Gehilfe	Gehilfen
Gehorsam	—
Gehsteig	Gehsteige
Gehweg	Gehwege
Geier	Geier
Geiger	Geiger
Geiselnehmer	Geiselnehmer
Geist	Geisten
Geisterfahrer	Geisterfahrer
Geiz	Geize
Geldautomat	Geldautomaten
Geldbetrag	Geldbeträge
Geldbeutel	Geldbeutel
Geldfluss	Geldflüsse
Geldgeber	Geldgeber
Geldhahn	Geldhähne	Geldhahnen
Geldmangel	Geldmängel
Geldmarkt	Geldmärkte
Geldschein	Geldscheine
Geldsegen	Geldsegen
Geländewagen	Geländewagen
Gemahl	Gemahle
Gemeindeammann	Gemeindeammänner
Gemeinderat	Gemeinderäte
Gemeindesaal	Gemeindesäle
Gemeindeschreiber	Gemeindeschreiber
Gemeindeverband	Gemeindeverbände
Gemeindevorstand	Gemeindevorstände
Gendarm	Gendarmen
Gendarmerieposten	Gendarmerieposten
General	Generale
Generalbundesanwalt	Generalbundesanwälte
Generaldirektor	Generaldirektoren
Generalinspekteur	Generalinspekteure
Generalintendant	Generalintendanten
Generalkonsul	Generalkonsuln
Generalleutnant	Generalleutnante	Generalleutnants
Generalmajor	Generalmajore
Generalmusikdirektor	Generalmusikdirektoren
Generalsekretär	Generalsekretäre
Generalstaatsanwalt	Generalstaatsanwälte
Generalstab	Generalstäbe
Generalstabschef	Generalstabschefs
Generalstreik	Generalstreiks	Generalstreike
Generalunternehmer	Generalunternehmer
Generalvikar	Generalvikare
Generationenvertrag	Generationenverträge
Generationswechsel	Generationswechsel
Generator	Generatoren
Genius	Genien
Genosse	Genossen
Genossenschafter	Genossenschafter
Genozid	Genozide	Genozidien
Gentest	Gentests	Genteste
Gentleman	Gentlemen
Genuss	Genüsse
Geologe	Geologen
Gepäckträger	Gepäckträger
Ger	Gere
Gerber	Gerber
Gerichtsbeschluss	Gerichtsbeschlüsse
Gerichtshof	Gerichtshöfe
Gerichtsmediziner	Gerichtsmediziner
Gerichtssaal	Gerichtssäle
Gerichtsvollzieher	Gerichtsvollzieher
Germane	Germanen
Germanist	Germanisten
Gerstensaft	Gerstensäfte
Geruch	Gerüche
Gesamtbetriebsrat	Gesamtbetriebsräte
Gesamteindruck	Gesamteindrücke
Gesamtschaden	Gesamtschäden
Gesamtsieg	Gesamtsiege
Gesamtsieger	Gesamtsieger
Gesamtumsatz	Gesamtumsätze
Gesamtverband	Gesamtverbände
Gesamtwert	Gesamtwerte
Gesang	Gesänge
Gesangverein	Gesangvereine
Geschlechtsverkehr	—
Geschmack	Geschmäcke
Geschäftsführer	Geschäftsführer
Geschäftsmann	Geschäftsleute
Geselle	Gesellen
Gesellschafter	Gesellschafter
Gesetzentwurf	Gesetzentwürfe
Gesetzesentwurf	Gesetzesentwürfe
Gesetzestext	Gesetzestexte
Gesetzgeber	Gesetzgeber
Gesichtsausdruck	Gesichtsausdrücke
Gesichtspunkt	Gesichtspunkte
Gesichtszug	Gesichtszüge
Gesinnungsgenosse	Gesinnungsgenossen
Gest	—
Gestalter	Gestalter
Gestank	—
Gestus	—
Gesundheitsexperte	Gesundheitsexperten
Gesundheitsminister	Gesundheitsminister
Gesundheitsschaden	Gesundheitsschäden
Gesundheitsschutz	—
Gesundheitszustand	Gesundheitszustände
Gewahrsam	—
Gewaltakt	Gewaltakte
Gewaltverzicht	Gewaltverzichte
Gewerbebetrieb	Gewerbebetriebe
Gewerbepark	Gewerbeparks
Gewerbeverband	Gewerbeverbände
Gewerbeverein	Gewerbevereine
Gewerkschafter	Gewerkschafter
Gewerkschaftsbund	Gewerkschaftsbünde
Gewerkschaftschef	Gewerkschaftschefs
Gewerkschaftstag	Gewerkschaftstage
Gewichtheber	Gewichtheber
Gewinn	Gewinne
Gewinneinbruch	Gewinneinbrüche
Gewinner	Gewinner
Giftstoff	Giftstoffe
Gigant	Giganten
Gin	Gins
Gipfel	Gipfel
Gips	Gipse
Gitarrist	Gitarristen
Gladiator	Gladiatoren
Glamour	—
Glanz	—
Glanzpunkt	Glanzpunkte
Glaser	Glaser
Glaube	Glauben
Gleichheitsgrundsatz	Gleichheitsgrundsätze
Gleichklang	Gleichklänge
Gleichschritt	—
Gletscher	Gletscher
Globus	Globusse
Gloria	Glorias
Glücksbringer	Glücksbringer
Glücksfall	Glücksfälle
Glückspilz	Glückspilze
Glückstag	Glückstage
Glückstreffer	Glückstreffer
Glückwunsch	Glückwünsche
Goalgetter	Goalgetter
Goalie	Goalies
Goldpreis	Goldpreise
Goldschmied	Goldschmiede
Golfer	Golfer
Golfkrieg	Golfkriege
Golfplatz	Golfplätze
Golfstaat	Golfstaaten
Gong	Gongs
Goodwill	—
Gorilla	Gorillas
Gott	Götter
Gottesdienst	Gottesdienste
Gourmet	Gourmets
Gouverneur	Gouverneure
Graben	Graben
Grabenkampf	Grabenkämpfe
Grabräuber	Grabräuber
Grabstein	Grabsteine
Grad	Grade
Gradmesser	Gradmesser
Graf	Grafen
Graffito	Graffiti
Grafiker	Grafiker
Gram	—
Grande	Granden
Granit	Granite
Grant	—
Grat	Grate
Gratulant	Gratulanten
Greif	Greife	Greifen
Greis	Greise
Grenzbereich	Grenzbereiche
Grenzer	Grenzer
Grenzschutz	—
Grenzsoldat	Grenzsoldaten
Grenzwert	Grenzwerte
Grieche	Griechen
Griff	Griffe
Grill	Grills
Grips	—
Groll	—
Groschen	Groschen
Großpapa	Großpapas
Großteil	Großteile
Großvater	Großväter
Grund	Gründe
Grundbesitz	—
Grundbesitzer	Grundbesitzer
Grundgedanke	Grundgedanken
Grundkurs	Grundkurse
Grundpreis	Grundpreise
Grundriss	Grundrisse
Grundsatz	Grundsätze
Grundsatzbeschluss	Grundsatzbeschlüsse
Grundstein	Grundsteine
Grundstock	Grundstöcke
Grundstoff	Grundstoffe
Grundton	Grundtöne
Grundwert	Grundwerte
Grundzug	Grundzüge
Grunge	—
Gruppensieg	Gruppensiege
Gruppensieger	Gruppensieger
Gruß	Grüße
Guardian	Guardiane
Guerillero	Guerilleros
Guide	Guides
Gulasch	Gulasche	Gulaschs
Gulden	Gulden
Gummi	Gummis
Gummistiefel	Gummistiefel
Gun	Guns
Gurt	Gurte
Guru	Gurus
Guss	Güsse
Gusto	Gustos
Gutachter	Gutachter
Gutschein	Gutscheine
Gutshof	Gutshöfe
Gymnasiast	Gymnasiasten
Gynäkologe	Gynäkologen
Gärtner	Gärtner
Gönner	Gönner
Gürtel	Gürtel
Haag	—
Haarschnitt	Haarschnitte
Haber	—
Haberer	Haberer
Habitus	—
Hack	Hacks
Hacker	Hacker
Hafen	Häfen
Haftbefehl	Haftbefehle
Haftrichter	Haftrichter
Hag	Hage
Hagel	—
Hahn	Hähne	Hahnen
Hahnenkamm	Hahnenkämme
Hai	Hais
Hain	Haine
Haken	Haken
Halbbruder	Halbbrüder
Halbleiter	Halbleiter
Halbmarathon	Halbmarathons
Halbmond	Halbmonde
Haller	Haller
Hals	Hälse
Halt	Halte	Halts
Haltepunkt	Haltepunkte
Halter	Halter
Hamburger	Hamburger
Hammer	Hämmer
Hamster	Hamster
Han	Hane	Hans
Handball	Handbälle
Handballer	Handballer
Handelskonzern	Handelskonzerne
Handelsminister	Handelsminister
Handelspartner	Handelspartner
Handelsplatz	Handelsplätze
Handelsschluss	Handelsschlüsse
Handelstag	Handelstage
Handgriff	Handgriffe
Handlanger	Handlanger
Handlungsbedarf	Handlungsbedarfe
Handlungsspielraum	Handlungsspielräume
Handschlag	Handschläge
Handschuh	Handschuhe
Handwerker	Handwerker
Handwerksbetrieb	Handwerksbetriebe
Handzettel	Handzettel
Hanf	—
Hang	Hänge
Hangar	Hangars
Hanseat	Hanseaten
Hardcore	—
Hardliner	Hardliner
Harm	—
Harnisch	Harnische
Hartmann	Hartmanns
Hartplatz	Hartplätze
Hartung	Hartunge
Haschisch	—
Hase	Hasen
Haslinger	Haslinger
Hass	—
Hattrick	Hattricks
Hau	Haue
Hauch	Hauche
Haudegen	Haudegen
Hauer	Hauer	Hauersleute	Häuer
Haufen	Haufen
Hauptakteur	Hauptakteure
Hauptausschuss	Hauptausschüsse
Hauptbahnhof	Hauptbahnhöfe
Hauptberuf	Hauptberufe
Hauptdarsteller	Hauptdarsteller
Haupteingang	Haupteingänge
Hauptgewinn	Hauptgewinne
Hauptgrund	Hauptgründe
Hauptkommissar	Hauptkommissare
Hauptkonkurrent	Hauptkonkurrenten
Hauptort	Hauptorte
Hauptpreis	Hauptpreise
Hauptschulabschluss	Hauptschulabschlüsse
Hauptsitz	Hauptsitze
Hauptsponsor	Hauptsponsoren
Hauptteil	Hauptteile
Hauptverband	Hauptverbände
Hauptwohnsitz	Hauptwohnsitze
Hausarrest	Hausarreste
Hausarzt	Hausärzte
Hausbau	Hausbauten
Hausbesetzer	Hausbesetzer
Hausbesitzer	Hausbesitzer
Hausbesuch	Hausbesuche
Hausbewohner	Hausbewohner
Hauseingang	Hauseingänge
Hausen	Hausen
Hauser	Hausers	Hauser
Hausflur	Hausflure
Hausfriedensbruch	Hausfriedensbrüche
Haushalt	Haushalte
Haushalter	Haushalter
Haushaltsausschuss	Haushaltsausschüsse
Haushaltsentwurf	Haushaltsentwürfe
Haushaltsexperte	Haushaltsexperten
Haushaltsplan	Haushaltspläne
Hausherr	Hausherren
Hausmann	Hausmänner
Hausmeister	Hausmeister
Hausrat	—
Hautkrebs	Hautkrebse
Hebel	Hebel
Heber	Heber
Hecht	Hechte
Heiland	Heilanden
Heiligabend	Heiligabende
Heilpraktiker	Heilpraktiker
Heimatmarkt	Heimatmärkte
Heimatort	Heimatorte
Heimatverein	Heimatvereine
Heimbewohner	Heimbewohner
Heimkehrer	Heimkehrer
Heimleiter	Heimleiter
Heimsieg	Heimsiege
Heimvorteil	Heimvorteile
Heimweg	Heimwege
Hektar	Hektare
Hektoliter	Hektoliter
Held	Helden
Helfer	Helfer
Helikopter	Helikopter
Heller	Heller
Helm	Helme
Hengst	Hengste
Henkel	Henkel
Henker	Henker
Herausforderer	Herausforderer
Herausgeber	Herausgeber
Herbst	Herbste
Herd	Herde
Hergang	Hergänge
Hering	Heringe
Herold	Herolde
Heros	Heroen
Herr	Herren
Herrgott	—
Herrscher	Herrscher
Hersteller	Hersteller
Herzanfall	Herzanfälle
Herzinfarkt	Herzinfarkte
Herzog	Herzöge
Herzschlag	Herzschläge
Hexenkessel	Hexenkessel
Hickhack	Hickhacks
Hieb	Hiebe
Highway	Highways
Hilferuf	Hilferufe
Hilfsarbeiter	Hilfsarbeiter
Hilfsdienst	Hilfsdienste
Himalaja	—
Himmel	Himmel
Hinterausgang	Hinterausgänge
Hintereingang	Hintereingänge
Hintergedanke	Hintergedanken
Hintergrund	Hintergründe
Hinterhalt	Hinterhalte
Hinterhof	Hinterhöfe
Hinterkopf	Hinterköpfe
Hintermann	Hintermänner	Hinterleute
Hintern	Hintern
Hinterwäldler	Hinterwäldler
Hinweis	Hinweise
Hippie	Hippies
Hirsch	Hirsche	Hirschen
Hirt	Hirten
Hirte	Hirten
Historiker	Historiker
Hit	Hits
Hochbau	Hochbauten
Hochbetrieb	Hochbetriebe
Hochgeschwindigkeitszug	Hochgeschwindigkeitszüge
Hochglanz	—
Hochmut	—
Hochofen	Hochöfen
Hochschulabsolvent	Hochschulabsolventen
Hochschullehrer	Hochschullehrer
Hochsommer	Hochsommer
Hochsprung	Hochsprünge
Hochstapler	Hochstapler
Hochverrat	Hochverrate
Hochwasserschutz	—
Hochzeitstag	Hochzeitstage
Hocker	Hocker
Hoden	Hoden
Hof	Höfe
Hoffnungsschimmer	Hoffnungsschimmer
Hofgarten	Hofgärten
Hofmann	Hofmanns
Hofmeister	Hofmeister
Hofrat	Hofräte
Hofstaat	Hofstaaten
Hohlraum	Hohlräume
Hohn	—
Holocaust	Holocausts
Holzbau	Holzbauten
Holzschnitt	Holzschnitte
Holzweg	Holzwege
Homburg	Homburgs
Honig	Honige
Hooligan	Hooligans
Hopfen	Hopfen
Horizont	Horizonte
Hornung	Hornunge
Horror	—
Horrorfilm	Horrorfilme
Hort	Horte
Hosenträger	Hosenträger
Hotelgast	Hotelgäste
Hotelier	Hoteliers
Huber	Huber
Hubraum	Hubräume
Hubschrauber	Hubschrauber
Huf	Hufe
Humanismus	Humanismen
Humanist	Humanisten
Hummer	Hummer
Hund	Hunde
Hundebesitzer	Hundebesitzer
Hundehalter	Hundehalter
Hundekot	—
Hunderter	Hunderter
Hunger	—
Hungerstreik	Hungerstreiks
Hunt	Hunte
Hunter	Hunter
Hurrikan	Hurrikans	Hurrikane
Husten	Husten
Hymnus	Hymnen
Häftling	Häftlinge
Häuptling	Häuptlinge
Hörer	Hörer
Hügel	Hügel
Hühnerstall	Hühnerställe
Hüter	Hüter
Ibis	Ibisse
Idealfall	Idealfälle
Idealismus	—
Idealist	Idealisten
Ideenwettbewerb	Ideenwettbewerbe
Ideologe	Ideologen
Idiot	Idioten
Igel	Igel
Imageschaden	Imageschäden
Imam	Imame	Imams
Imbiss	Imbisse
Imker	Imker
Immigrant	Immigranten
Immobilienmakler	Immobilienmakler
Immobilienmarkt	Immobilienmärkte
Imperativ	Imperative
Imperialismus	Imperialismen
Impfstoff	Impfstoffe
Import	Importe
Importeur	Importeure
Impressionismus	—
Impressionist	Impressionisten
Impuls	Impulse
Inbegriff	Inbegriffe
Inder	Inder
Index	Indizes	Indices	Indexe
Indianer	Indianer
Indikator	Indikatoren
Indio	Indios
Individualismus	—
Individualist	Individualisten
Individualverkehr	—
Indonesier	Indonesier
Industriebetrieb	Industriebetriebe
Industriekonzern	Industriekonzerne
Industrieminister	Industrieminister
Industriepark	Industrieparks	Industrieparke	Industriepärke
Industriestaat	Industriestaaten
Industriestandort	Industriestandorte
Industrieverband	Industrieverbände
Industriezweig	Industriezweige
Infarkt	Infarkte
Infekt	Infekte
Informant	Informanten
Informatiker	Informatiker
Informationsabend	Informationsabende
Informationsaustausch	Informationsaustausche
Informationsdienst	Informationsdienste
Informationsfluss	Informationsflüsse
Informationsstand	Informationsstände
Infostand	Infostände
Ingenieur	Ingenieure
Inhaber	Inhaber
Inhalt	Inhalte
Inhaltsstoff	Inhaltsstoffe
Initiant	Initianten
Initiator	Initiatoren
Inka	Inka	Inkas
Inn	—
Innenausbau	Innenausbauten
Innenausschuss	Innenausschusse
Innenhof	Innenhöfe
Innenminister	Innenminister
Innenpolitiker	Innenpolitiker
Innenraum	Innenräume
Innensenator	Innensenatoren
Input	Inputs
Insasse	Insassen
Inselstaat	Inselstaaten
Insider	Insider
Insolvenzantrag	Insolvenzanträge
Insolvenzverwalter	Insolvenzverwalter
Inspekteur	Inspekteure
Inspektor	Inspektoren
Installateur	Installateure
Instinkt	Instinkte
Instrumentalist	Instrumentalisten
Insulaner	Insulaner
Intellekt	Intellekte
Intendant	Intendanten
Intercity	Intercitys
Interessenkonflikt	Interessenkonflikte
Interessent	Interessenten
Interessenverband	Interessenverbände
Interessenvertreter	Interessenvertreter
Internetzugang	Internetzugänge
Internist	Internisten
Interpret	Interpreten
Interregio	Interregios
Intershop	Intershops
Interviewer	Interviewer
Investor	Investoren
Inzest	Inzeste
Irak	—
Iraker	Iraker
Irakkrieg	Irakkriege
Iran	—
Iraner	Iraner
Ire	Iren
Irre	Irren
Irrsinn	—
Irrtum	Irrtümer
Irrweg	Irrwege
Islam	Islame
Islamismus	—
Islamist	Islamisten
Italiener	Italiener
Jackpot	Jackpots
Jaguar	Jaguare
Jahresabschluss	Jahresabschlüsse
Jahresanfang	Jahresanfänge
Jahresbeginn	Jahresbeginne
Jahresbeitrag	Jahresbeiträge
Jahresbericht	Jahresberichte
Jahresdurchschnitt	Jahresdurchschnitte
Jahrestag	Jahrestage
Jahresumsatz	Jahresumsätze
Jahresvergleich	Jahresvergleiche
Jahresverlauf	Jahresverläufe
Jahreswechsel	Jahreswechsel
Jahrgang	Jahrgänge
Jahrmarkt	Jahrmärkte
Jahrtausendwechsel	Jahrtausendwechsel
Jammer	—
Januar	Januare
Japaner	Japaner
Jargon	Jargons
Jasmin	Jasmine
Jazz	—
Jazzer	Jazzer
Jazzmusiker	Jazzmusiker
Jeep	Jeeps
Jemen	—
Jerez	—
Jesuit	Jesuiten
Jet	Jets
Job	Jobs
Jockey	Jockeys
Jodler	Jodler
Jogger	Jogger
Joghurt	Joghurts
Johanniter	Johanniter
Joint	Joints
Joker	Joker
Jongleur	Jongleure
Jordan	—
Jordanier	Jordanier
Journalismus	—
Journalist	Journalisten
Jubel	—
Jubilar	Jubilare
Jude	Juden
Jugendbereich	Jugendbereiche
Jugendchor	Jugendchöre
Jugendleiter	Jugendleiter
Jugendschutz	—
Jugendstil	—
Jugendtreff	Jugendtreffs
Jugendverband	Jugendverbände
Jugoslawe	Jugoslawen
Jumbo	Jumbos
Jungbauer	Jungbauern
Junge	Jungen	Jungs	Jungens
Junggeselle	Junggesellen
Jungsozialist	Jungsozialiste
Jungstar	Jungstars
Jungunternehmer	Jungunternehmer
Juni	Junis
Junior	Junioren
Juniorpartner	Juniorpartner
Junker	Junker
Junkie	Junkien
Jurist	Juristen
Juror	Juroren
Justizminister	Justizminister
Justizsenator	Justizsenatoren
Justizsprecher	Justizsprecher
Juwel	Juwele
Juwelier	Juweliere
Jux	Juxe
Jäger	Jäger
Jüngling	Jünglinge
Kabarettist	Kabarettisten
Kachelofen	Kachelöfen
Kadaver	Kadaver
Kader	Kader
Kadi	Kadis
Kaffee	Kaffeen
Kahlschlag	Kahlschläge
Kahn	Kähne
Kai	Kais
Kaiser	Kaiser
Kaiserschnitt	Kaiserschnitte
Kajak	Kajaks
Kakao	Kakaos
Kakerlak	Kakerlaken
Kaktus	Kakteen
Kalender	Kalender
Kalif	Kalifen
Kalk	Kalke
Kamerad	Kameraden
Kameramann	Kameramänner	Kameraleute
Kamin	Kamine
Kamm	Kämme
Kammerchor	Kammerchöre
Kamp	—
Kampf	Kämpfe
Kampfeinsatz	Kampfeinsätze
Kampfgeist	—
Kampfhubschrauber	Kampfhubschrauber
Kampfhund	Kampfhunde
Kampfjet	Kampfjets
Kampfrichter	Kampfrichter
Kampfstoff	Kampfstoffe
Kanadier	Kanadier
Kanal	Kanäle
Kandidat	Kandidaten
Kanister	Kanister
Kannibale	Kannibalen
Kanten	Kanten
Kantersieg	Kantersiege
Kantonsrat	Kantonsräte
Kantonsspital	Kantonsspitäler
Kantor	Kantoren
Kanute	Kanuten
Kanzler	Kanzler
Kanzleramtsminister	Kanzleramtsminister
Kanzlerkandidat	Kanzlerkandidaten
Kapellmeister	Kapellmeister
Kapitalertrag	Kapitalerträge
Kapitalismus	Kapitalismen
Kapitalist	Kapitalisten
Kapitalmarkt	Kapitalmärkte
Kapitän	Kapitäne
Kaplan	Kapläne
Karabach	Karabachs
Kardinal	Kardinäle
Karfreitag	Karfreitage
Karikaturist	Karikaturisten
Karneval	Karnevale
Karnevalist	Karnevalisten
Karpfen	Karpfen
Karren	Karren
Kart	Karts
Kartenverkauf	Kartenverkäufe
Kartenvorverkauf	Kartenvorverkäufe
Karton	Kartons	Kartone
Kasper	Kasper
Kassenarzt	Kassenärzte
Kassenschlager	Kassenschlager
Kassenwart	Kassenwarte
Kassier	Kassiere
Kassierer	Kassierer
Kasten	Kästen	Kasten
Katalane	Katalanen
Katalog	Kataloge
Katalysator	Katalysatoren
Katastrophenschutz	—
Kater	Kater
Katholik	Katholiken
Katholizismus	—
Katzenjammer	—
Kauder	—
Kauf	Käufe
Kaufinteressent	Kaufinteressenten
Kaufmann	Kaufmänner
Kaufpreis	Kaufpreise
Kaufvertrag	Kaufverträge
Kaugummi	Kaugummis
Kaukasus	—
Kavalier	Kavaliere
Kaviar	Kaviare
Keeper	Keeper
Kegel	Kegel
Kegler	Kegler
Keil	Keile
Keim	Keime
Keks	Kekse
Kelch	Kelche
Kellerraum	Kellerräume
Kellner	Kellner
Kenner	Kenner
Kerker	Kerker
Kerl	Kerle
Kern	Kerne
Kernbereich	Kernbereiche
Kernpunkt	Kernpunkte
Kessel	Kessel
Ketchup	Ketchups
Keyboarder	Keyboarder
Khan	Khane
Kick	Kicks
Kicker	Kicker
Kidnapper	Kidnapper
Kies	Kiese
Kiez	Kieze
Killer	Killer
Kilo	Kilo	Kilos
Kilometer	Kilometer
Kinderarzt	Kinderärzte
Kinderchor	Kinderchöre
Kinderfilm	Kinderfilme
Kinderfreund	Kinderfreunde
Kindergarten	Kindergärten
Kindergartenplatz	Kindergartenplätze
Kinderhort	Kinderhorte
Kinderschuh	Kinderschuhe
Kinderschutzbund	Kinderschutzbünde
Kinderschänder	Kinderschänder
Kindersitz	Kindersitze
Kinderspielplatz	Kinderspielplätze
Kinderspital	Kinderspitäler
Kindertag	Kindertage
Kinderwagen	Kinderwagen	Kinderwägen
Kinderwunsch	Kinderwünsche
Kindesmissbrauch	Kindesmissbräuche
Kinofilm	Kinofilme
Kinosaal	Kinosäle
Kiosk	Kioske
Kirchenchor	Kirchenchöre
Kirchenkreis	Kirchenkreise
Kirchenrat	Kirchenräte
Kirchentag	Kirchentage
Kirchenvorstand	Kirchenvorstände
Kirchhof	Kirchhöfe
Kirchner	Kirchner
Kirchplatz	Kirchplätze
Kirchturm	Kirchtürme
Kirsch	Kirsch
Kitt	Kitte
Kittel	Kittel
Klamauk	—
Klan	Klane
Klang	Klänge
Klarinettist	Klarinettisten
Klartext	Klartexte
Klassenerhalt	Klassenerhalte
Klassenkamerad	Klassenkameraden
Klassenkampf	Klassenkämpfe
Klassenlehrer	Klassenlehrer
Klassenraum	Klassenräume
Klassiker	Klassiker
Klassizismus	Klassizismen
Klatsch	Klatsche
Kleber	Kleber
Klebstoff	Klebstoffe
Kleiber	Kleiber
Kleiderschrank	Kleiderschränke
Kleinanleger	Kleinanleger
Kleinbauer	Kleinbauern
Kleinbetrieb	Kleinbetriebe
Kleinbus	Kleinbusse
Kleingarten	Kleingärten
Kleinkrieg	Kleinkriege
Kleinstaat	Kleinstaaten
Kleintransporter	Kleintransporter
Kleinwagen	Kleinwagen	Kleinwägen
Klerus	—
Kletterer	Kletterer
Klient	Klienten
Klimaschutz	—
Klimawandel	Klimawandel
Klon	Klone
Klotz	Klötze
Klub	Klubs
Klubchef	Klubchefs
Klubobmann	Klubobmänner	Klubobleute
Klumpen	Klumpen
Knabe	Knaben
Knacker	Knacker
Knackpunkt	Knackpunkte
Knall	Knalle
Knalleffekt	Knalleffekte
Knaller	Knaller
Knappe	Knappen
Knecht	Knechte
Knick	Knicke	Knicks
Kniefall	Kniefälle
Kniff	Kniffe
Knigge	Knigge	Knigges
Knight	Knights
Knirps	Knirpse
Knoblauch	—
Knochen	Knochen
Knochenbruch	Knochenbrüche
Knopf	Knöpfe
Knopfdruck	Knopfdrücke
Knopp	Knöppe
Knorr	Knorrs
Knoten	Knoten
Knotenpunkt	Knotenpunkte
Knüppel	Knüppel
Koalitionsausschuss	Koalitionsausschüsse
Koalitionspartner	Koalitionspartner
Koalitionsvertrag	Koalitionsverträge
Kober	Kober
Kobold	Kobolde
Koch	Köche
Kochtopf	Kochtöpfe
Kode	Koden
Kodex	Kodexe	Kodizes
Koffer	Koffer
Kofferraum	Kofferräume
Kohl	Kohle
Kohlenstoff	—
Kohlenwasserstoff	Kohlenwasserstoffe
Koks	—
Kollaborateur	Kollaborateure
Kollaps	Kollapse
Kollege	Kollegen
Kollektivvertrag	Kollektivverträge
Kolonialherr	Kolonialherren
Kolonialismus	—
Koloss	Kolosse
Kolumbianer	Kolumbianer
Kolumnist	Kolumnisten
Kombilohn	Kombilöhne
Kombinierer	Kombinierer
Komet	Kometen
Komfort	—
Komiker	Komiker
Kommandant	Kommandanten
Kommandeur	Kommandeure
Kommentar	Kommentare
Kommentator	Kommentatoren
Kommerz	—
Kommilitone	Kommilitonen
Kommissar	Kommissare
Kommunalpolitiker	Kommunalpolitiker
Kommunismus	—
Kommunist	Kommunisten
Kompagnon	Kompagnons
Kompass	Kompasse
Komplex	Komplexe
Komplize	Komplizen
Komplott	Komplotte
Komponist	Komponisten
Kompost	—
Kompressor	Kompressoren
Kompromiss	Kompromisse
Kompromissvorschlag	Kompromissvorschläge
Konditor	Konditoren
Kondom	Kondome
Konferenzraum	Konferenzräume
Konfirmand	Konfirmanden
Konflikt	Konflikte
Konfrontationskurs	Konfrontationskurse
Kongress	Kongresse
Konjunkturaufschwung	Konjunkturaufschwünge
Konkurrent	Konkurrenten
Konkurrenzdruck	—
Konkurrenzkampf	Konkurrenzkämpfe
Konkurs	Konkurse
Konkursantrag	Konkursanträge
Konkursverwalter	Konkursverwalter
Konsens	Konsense
Konsorte	Konsorten
Konstrukteur	Konstrukteure
Konsul	Konsuln
Konsument	Konsumenten
Konsumentenschutz	—
Kontakt	Kontakte
Konter	Konter
Kontext	Kontexte
Kontinent	Kontinente
Kontrabass	Kontrabässe
Kontrahent	Kontrahenten
Kontrakt	Kontrakte
Kontrapunkt	Kontrapunkte
Kontrast	Kontraste
Kontrollausschuss	Kontrollausschüsse
Kontrolleur	Kontrolleure
Kontrollpunkt	Kontrollpunkte
Kontur	Konturen
Konvent	Konvente
Konvoi	Konvois
Konzentrationsprozess	Konzentrationsprozesse
Konzern	Konzerne
Konzernchef	Konzernchefs
Konzerngewinn	Konzerngewinne
Konzernumsatz	Konzernumsätze
Konzertabend	Konzertabende
Konzertbesucher	Konzertbesucher
Konzertsaal	Konzertsäle
Konzertveranstalter	Konzertveranstalter
Kooperationspartner	Kooperationspartner
Kooperationsvertrag	Kooperationsverträge
Koordinator	Koordinatoren
Kopf	Köpfe
Kopfball	Kopfbälle
Kopfgeldjäger	Kopfgeldjäger
Kopfhörer	Kopfhörer
Kopfschmerz	Kopfschmerzen
Kopfschuss	Kopfschüsse
Kopierer	Kopierer
Koran	Korane
Korb	Körbe
Koreaner	Koreaner
Kork	Korke
Korken	Korken
Kormoran	Kormorane
Korrespondent	Korrespondenten
Korridor	Korridore
Korruptionsskandal	Korruptionsskandale
Korruptionsvorwurf	Korruptionsvorwürfe
Kosak	Kosaken
Kosmonaut	Kosmonauten
Kosmos	—
Kostenaufwand	Kostenaufwände
Kostendruck	—
Kostenfaktor	Kostenfaktoren
Kostenpunkt	Kostenpunkte
Kostenvoranschlag	Kostenvoranschläge
Kostenvorteil	Kostenvorteile
Kot	Kote
Krach	Kräche
Kracher	Kracher
Kraftakt	Kraftakte
Kraftfahrer	Kraftfahrer
Kraftstoff	Kraftstoffe
Kragen	Kragen
Kram	—
Kramer	Kramer
Krampf	Krämpfe
Kran	Kräne
Kranich	Kraniche
Krankenhausaufenthalt	Krankenhausaufenthalte
Krankenpfleger	Krankenpfleger
Krankenschein	Krankenscheine
Krankenstand	Krankenstände
Krankenwagen	Krankenwagen
Krankheitserreger	Krankheitserreger
Krankheitsfall	Krankheitsfälle
Kranz	Kränze
Krater	Krater
Kratzer	Kratzer
Krawall	Krawalle
Krebs	Krebse
Krebspatient	Krebspatienten
Kreditgeber	Kreditgeber
Kreditnehmer	Kreditnehmer
Kreditzins	Kreditzinsen
Kreis	Kreise
Kreisausschuss	Kreisausschüsse
Kreisel	Kreisel
Kreislauf	Kreisläufe
Kreistag	Kreistage
Kreisverband	Kreisverbände
Kreisverkehr	Kreisverkehre
Kreisvorstand	Kreisvorstände
Kreml	Kreml
Kremser	Kremser
Kren	—
Kreuzbandriss	Kreuzbandrisse
Kreuzer	Kreuzer
Kreuzweg	Kreuzwege
Kreuzzug	Kreuzzüge
Krieg	Kriege
Krieger	Krieger
Kriegsbeginn	—
Kriegsdienst	Kriegsdienste
Kriegsdienstverweigerer	Kriegsdienstverweigerer
Kriegsgegner	Kriegsgegner
Kriegsschauplatz	Kriegsschauplätze
Kriegsverbrecher	Kriegsverbrecher
Kriegszustand	Kriegszustände
Krimi	Krimis
Kriminalfall	Kriminalfälle
Kriminalist	Kriminalisten
Kriminalroman	Kriminalromane
Kris	Krise
Krisengipfel	Krisengipfel
Krisenstab	Krisenstäbe
Kristall	Kristalle
Kritiker	Kritiker
Kritikpunkt	Kritikpunkte
Kroate	Kroaten
Kronprinz	Kronprinzen
Kronzeuge	Kronzeugen
Krug	Krüge
Krupp	—
Krümel	Krümel
Krüppel	Krüppel
Kubaner	Kubaner
Kubikmeter	Kubikmeter
Kubikzentimeter	Kubikzentimeter
Kubus	Kuben
Kuchen	Kuchen
Kuckuck	Kuckucke
Kugelschreiber	Kugelschreiber
Kult	Kulte
Kultstatus	Kultstatusse
Kulturausschuss	Kulturausschüsse
Kulturbetrieb	Kulturbetriebe
Kulturdezernent	Kulturdezernenten
Kulturkampf	Kulturkämpfe
Kulturkreis	Kulturkreise
Kulturminister	Kulturminister
Kulturpreis	Kulturpreise
Kulturreferent	Kulturreferenten
Kultursenator	Kultursenatoren
Kulturstaatsminister	Kulturstaatsminister
Kultusminister	Kultusminister
Kummer	—
Kumpan	Kumpane
Kumpel	Kumpel
Kunde	Kunden
Kundendienst	Kundendienste
Kundenkreis	Kundenkreise
Kundenservice	Kundenservices
Kundenwunsch	Kundenwünsche
Kunstbetrieb	Kunstbetriebe
Kunstfehler	Kunstfehler
Kunstfreund	Kunstfreunde
Kunstgegenstand	Kunstgegenstände
Kunstgriff	Kunstgriffe
Kunsthistoriker	Kunsthistoriker
Kunstmarkt	Kunstmärkte
Kunstpreis	Kunstpreise
Kunstrasen	Kunstrasen
Kunstsammler	Kunstsammler
Kunstschatz	Kunstschätze
Kunststoff	Kunststoffe
Kunstverein	Kunstvereine
Kurator	Kuratoren
Kurde	Kurden
Kurdirektor	Kurdirektoren
Kurgast	Kurgäste
Kurier	Kuriere
Kurort	Kurorte
Kurpark	Kurparks	Kurparke	Kurpärke
Kurs	Kurse
Kursanstieg	Kursanstiege
Kurseinbruch	Kurseinbrüche
Kursgewinn	Kursgewinne
Kursleiter	Kursleiter
Kurssturz	Kursstürze
Kursteilnehmer	Kursteilnehmer
Kursus	Kurse
Kursverfall	Kursverfälle
Kursverlust	Kursverluste
Kurswechsel	Kurswechsel
Kurzbesuch	Kurzbesuche
Kurzfilm	Kurzfilme
Kurzschluss	Kurzschlüsse
Kurzurlaub	Kurzurlaube
Kuss	Küsse
Kutscher	Kutscher
Kutter	Kutter
Käfer	Käfer
Käfig	Käfige
Kämpfer	Kämpfer
Käufer	Käufer
König	Könige
Körper	Körper
Körperbau	Körperbaus
Kühlraum	Kühlräume
Kühlschrank	Kühlschränke
Künstler	Künstler
Kürbis	Kürbisse
Lacher	Lacher
Lachmuskel	Lachmuskeln
Lachs	Lachse
Lack	Lacke
Laden	Läden	Laden
Ladenbesitzer	Ladenbesitzer
Ladendieb	Ladendiebe
Ladendiebstahl	Ladendiebstähle
Ladenschluss	Ladenschlüsse
Ladentisch	Ladentische
Laderaum	Laderäume
Lagebericht	Lageberichte
Lagerbestand	Lagerbestände
Lagerraum	Lagerräume
Laie	Laien
Landammann	Landammänner
Landarbeiter	Landarbeiter
Landauer	Landauer
Landbau	—
Landeanflug	Landeanflüge
Landeplatz	Landeplätze
Landesbischof	Landesbischöfe
Landeschef	Landeschefs
Landeshauptmann	Landeshauptmänner	Landeshauptleute
Landesligist	Landesligisten
Landesmeister	Landesmeister
Landesparteitag	Landesparteitage
Landespolitiker	Landespolitiker
Landesrat	Landesräte
Landesrechnungshof	Landesrechnungshöfe
Landesschulrat	Landesschulräte
Landesvater	Landesväter
Landesverband	Landesverbände
Landesvorstand	Landesvorstände
Landfriedensbruch	Landfriedensbrüche
Landgraf	Landgrafen
Landkreis	Landkreise
Landrat	Landräte
Landschaftsschutz	—
Landsitz	Landsitze
Landsmann	Landsmänner	Landsleute
Landstrich	Landstriche
Landtag	Landtage
Landtagswahlkampf	Landtagswahlkämpfe
Landweg	Landwege
Landwirt	Landwirte
Landwirtschaftsminister	Landwirtschaftsminister
Langfinger	Langfinger
Langlauf	Langläufe
Langweiler	Langweiler
Lappen	Lappen
Laptop	Laptops
Laser	Laser
Laserstrahl	Laserstrahlen
Lastenausgleich	—
Laster	Laster
Lastkraftwagen	Lastkraftwagen	Lastkraftwägen
Lastwagen	Lastwagen
Lastwagenfahrer	Lastwagenfahrer
Lastzug	Lastzüge
Latino	Latinos
Lauf	Läufe
Laufsteg	Laufstege
Lauschangriff	Lauschangriffe
Laut	Laute
Lautsprecher	Lautsprecher
Lawinenabgang	Lawinenabgänge
Leader	Leader
Lebensabend	Lebensabende
Lebensabschnitt	Lebensabschnitte
Lebensbereich	Lebensbereiche
Lebensentwurf	Lebensentwürfe
Lebenslauf	Lebensläufe
Lebensmittelhandel	Lebensmittelhandel
Lebenspartner	Lebenspartner
Lebensraum	Lebensräume
Lebensretter	Lebensretter
Lebensstandard	Lebensstandards
Lebensstil	Lebensstile
Lebensumstand	Lebensumstände
Lebensunterhalt	—
Lebensversicherer	Lebensversicherer
Lebenswandel	—
Lebensweg	Lebenswege
Lebkuchen	Lebkuchen
Lech	—
Leckerbissen	Leckerbissen
Lederer	Lederer
Leerlauf	Leerläufe
Leerstand	Leerstände
Lehm	Lehme
Lehrauftrag	Lehraufträge
Lehrberuf	Lehrberufe
Lehrbetrieb	Lehrbetriebe
Lehrer	Lehrer
Lehrgang	Lehrgänge
Lehrling	Lehrlinge
Lehrmeister	Lehrmeister
Lehrplan	Lehrpläne
Lehrstuhl	Lehrstühle
Leib	Leiber
Leichnam	Leichname
Leichtathlet	Leichtathleten
Leichter	Leichter
Leichtsinn	—
Leidensweg	Leidenswege
Leim	Leime
Leisten	Leisten
Leistungsdruck	—
Leistungssport	—
Leitantrag	Leitanträge
Leitartikel	Leitartikel
Leitfaden	Leitfäden
Leitgeb	Leitgeben
Leitindex	Leitindexe	Leitindices	Leitindizes
Leitsatz	Leitsätze
Leitzins	Leitzinsen
Lektor	Lektoren
Lenker	Lenker
Lenz	Lenze
Lenzing	Lenzinge
Leopard	Leoparden
Lernprozess	Lernprozesse
Leser	Leser
Leserbrief	Leserbriefe
Letten	Letten
Lettner	Lettner
Leuchtturm	Leuchttürme
Leutnant	Leutnante	Leutnants
Level	Levels
Lew	Lewa
Libanese	Libanesen
Libanon	—
Liberalismus	—
Libero	Liberos
Lichtblick	Lichtblicke
Lichtstrahl	Lichtstrahlen
Liebesbrief	Liebesbriefe
Liebeskummer	—
Liebhaber	Liebhaber
Liebling	Lieblinge
Liederabend	Liederabende
Liedermacher	Liedermacher
Lieferant	Lieferanten
Liefervertrag	Lieferverträge
Lieferwagen	Lieferwagen
Liegestuhl	Liegestühle
Lifestyle	Lifestyles
Lift	Lifte
Ligist	Ligisten
Likör	Liköre
Limes	Limes	Limites
Linienbus	Linienbusse
Linienflug	Linienflüge
Linienrichter	Linienrichter
Lion	Lions
Lipizzaner	Lipizzaner
Lippenstift	Lippenstifte
Listenplatz	Listenplätze
Litauer	Litauer
Liter	Liter
Literat	Literaten
Literaturbetrieb	—
Literaturkritiker	Literaturkritiker
Literaturpreis	Literaturpreise
Literaturwissenschaftler	Literaturwissenschaftler
Live	Liven
Lizenznehmer	Lizenznehmer
Lkw	—
Lloyd	—
Lobbyist	Lobbyisten
Locher	Locher
Loft	Lofts
Logo	Logos
Lohn	Löhne
Lohnabschluss	Lohnabschlüsse
Lohnausgleich	Lohnausgleiche
Lokalaugenschein	Lokalaugenscheine
Lokalmatador	Lokalmatadore
Lokalpolitiker	Lokalpolitiker
Lokalrivale	Lokalrivalen
Lokalteil	Lokalteile
Lokführer	Lokführer
Look	Looks
Lorbeer	Lorbeeren
Lord	Lords
Lost	—
Lotse	Lotsen
Lotus	Lotus
Lover	Lover	Lovers
Luchs	Luchse
Luftangriff	Luftangriffe
Luftballon	Luftballons	Luftballone
Luftdruck	Luftdrücke	Luftdrucke
Luftkrieg	Luftkriege
Luftraum	Lufträume
Luftschlag	Luftschläge
Luftverkehr	Luftverkehre
Lummer	Lummer
Lump	Lumpen
Lunch	Lunchs
Lungenkrebs	Lungenkrebse
Lustgarten	Lustgärten
Luxus	—
Lyriker	Lyriker
Läufer	Läufer
Löffel	Löffel
Löwe	Löwen
Lügendetektor	Lügendetektoren
Lügendetektortest	Lügendetektortests
Lümmel	Lümmel
Macher	Macher
Macho	Machos
Machtanspruch	Machtansprüche
Machterhalt	—
Machthaber	Machthaber
Machtkampf	Machtkämpfe
Machtmissbrauch	Machtmissbräuche
Machtwechsel	Machtwechsel
Madison	Madisons
Maestro	Maestros	Maestri
Mafioso	Mafiosi
Magen	Mägen
Magier	Magier
Magister	Magister
Magnet	Magnete	Magneten
Mahl	Mahle
Mahner	Mahner
Mahr	Mahre
Mai	Mais
Maibaum	Maibäume
Main	—
Mainstream	—
Mais	Maise
Makel	Makel
Makler	Makler
Maler	Maler
Malteser	Malteser
Malwettbewerb	Malwettbewerbe
Manager	Manager
Mandant	Mandanten
Mandatar	Mandatare
Mangold	Mangolde
Mann	Männer
Manndecker	Manndecker
Mannequin	Mannequins
Mannschaftskollege	Mannschaftskollegen
Mantel	Mäntel
Marathon	Marathons
Markenartikel	Markenartikel
Markenname	Markennamen
Marketingleiter	Marketingleiter
Markgraf	Markgrafen
Markt	Märkte
Marktanteil	Marktanteile
Marktbeobachter	Marktbeobachter
Marktforscher	Marktforscher
Marktplatz	Marktplätze
Marktpreis	Marktpreise
Marktstand	Marktstände
Marktteilnehmer	Marktteilnehmer
Marktwert	Marktwerte
Marmor	Marmore
Marokkaner	Marokkaner
Marquis	Marquis
Marsch	Märsche
Marschall	Marschälle
Marxismus	—
Marxist	Marxisten
Maschinenbau	—
Maschinenbauer	Maschinenbauer
Maschinenraum	Maschinenräume
Maskenball	Maskenbälle
Maskottchen	Maskottchen
Massenmord	Massenmorde
Massenmörder	Massenmörder
Massenprotest	Massenproteste
Massentourismus	—
Masseur	Masseure
Masseverwalter	Masseverwalter
Mast	Masten
Master	Master
Masterplan	Masterpläne
Match	Matchs
Matchball	Matchbälle
Matchwinner	Matchwinner
Materialismus	—
Mathematiker	Mathematiker
Matrose	Matrosen
Matsch	—
Maturant	Maturanten
Matz	Matze	Matz
Mauerbau	—
Mauerfall	—
Maulkorb	Maulkörbe
Maulwurf	Maulwürfe
Maure	Mauren
Maurer	Maurer
Mausklick	Mausklicks
Mautner	Mautner
Mechaniker	Mechaniker
Mechanismus	Mechanismen
Medaillengewinner	Medaillengewinner
Medienbericht	Medienberichte
Medienkonzern	Medienkonzerne
Medienrummel	—
Medienunternehmer	Medienunternehmer
Medienvertreter	Medienvertreter
Mediziner	Mediziner
Medizinstudent	Medizinstudenten
Meeresboden	Meeresböden
Meeresgrund	Meeresgründe
Meeresspiegel	Meeresspiegel
Mehraufwand	Mehraufwände
Mehrkampf	Mehrkämpfe
Mehrwert	—
Meier	Meier
Meilenstein	Meilensteine
Meineid	Meineide
Meinungsaustausch	Meinungsaustausche
Meinungsforscher	Meinungsforscher
Meister	Meister
Meistersinger	Meistersinger
Meistertitel	Meistertitel
Mensch	Menschen
Menschenhandel	—
Menschenrechtler	Menschenrechtler
Menschenverstand	—
Mephisto	Mephistos
Messebesucher	Messebesucher
Messer	Messer
Messerstich	Messerstiche
Messias	Messiasse
Messwert	Messwerte
Met	—
Metaller	Metaller
Meteorit	Meteoriten	Meteorite
Meteorologe	Meteorologen
Meter	Meter
Metzger	Metzger
Metzler	Metzler
Mexikaner	Mexikaner
Mieter	Mieter
Mieterbund	Mieterbünde
Mieterverein	Mietervereine
Mietpreis	Mietpreise
Mietspiegel	Mietspiegel
Mietvertrag	Mietverträge
Mietwagen	Mietwagen
Mietzins	Mietzinse
Mika	Mikas
Mikrochip	Mikrochips
Mikrokosmos	—
Mikroorganismus	Mikroorganismen
Mikroprozessor	Mikroprozessoren
Militarismus	Militarismen
Milliardenbetrag	Milliardenbeträge
Milliardär	Milliardäre
Milliliter	Milliliter
Millimeter	Millimeter
Millionenbetrag	Millionenbeträge
Millionenschaden	Millionenschäden
Mindestlohn	Mindestlöhne
Mindeststandard	Mindeststandards
Mineralstoff	Mineralstoffe
Minister	Minister
Ministerialrat	Ministerialräte
Ministeriumssprecher	Ministeriumssprecher
Ministerposten	Ministerposten
Ministerrat	Ministerräte
Ministrant	Ministranten
Minivan	Minivans
Mischkonzern	Mischkonzerne
Mischling	Mischlinge
Missbrauch	Missbräuche
Misserfolg	Misserfolge
Missionar	Missionare
Misskredit	—
Missstand	Missstände
Misstrauensantrag	Misstrauensanträge
Mist	Misten
Mitarbeiter	Mitarbeiter
Mitbewerber	Mitbewerber
Mitbewohner	Mitbewohner
Mitbürger	Mitbürger
Mitfahrer	Mitfahrer
Mitgliedsbeitrag	Mitgliedsbeiträge
Mitgliedsstaat	Mitgliedsstaaten
Mitgliedstaat	Mitgliedstaaten
Mitherausgeber	Mitherausgeber
Mitmensch	Mitmenschen
Mitspieler	Mitspieler
Mitstreiter	Mitstreiter
Mittag	Mittage
Mittagstisch	Mittagstische
Mittelbau	Mittelbauten	Mittelbaue
Mittelbetrieb	Mittelbetriebe
Mittelfeldspieler	Mittelfeldspieler
Mittelmeerraum	—
Mittelpunkt	Mittelpunkte
Mittelsmann	Mittelsmänner
Mittelstand	—
Mittelteil	Mittelteile
Mittelweg	Mittelwege
Mittelwert	Mittelwerte
Mittler	Mittler
Mittwoch	Mittwoche
Mittwochabend	Mittwochabende
Mittwochmorgen	Mittwochmorgen
Mittwochnachmittag	Mittwochnachmittage
Mix	Mixe
Mixer	Mixer
Moabiter	Moabiter
Mob	Mobs
Mobilfunk	—
Mobilfunkanbieter	Mobilfunkanbieter
Mobilfunkbetreiber	Mobilfunkbetreiber
Mode	Moden
Modellversuch	Modellversuche
Modem	Modems
Modemacher	Modemacher
Moder	—
Moderator	Moderatoren
Modernisierer	Modernisierer
Modus	Modi
Mohn	Mohne
Mohr	Mohren
Molotowcocktail	Molotowcocktails
Monarch	Monarchen
Monat	Monate
Monatsbericht	Monatsberichte
Monatslohn	Monatslöhne
Mond	Monde
Monitor	Monitore	Monitoren
Monolog	Monologe
Monopolist	Monopolisten
Monsieur	Messieurs
Montag	Montage
Montagabend	Montagabende
Montagmorgen	Montagmorgen
Montagnachmittag	Montagnachmittage
Montblanc	—
Monteur	Monteure
Moralist	Moralisten
Mord	Morde
Mordanschlag	Mordanschläge
Mordfall	Mordfälle
Mordprozess	Mordprozesse
Mordverdacht	—
Mordversuch	Mordversuche
Morgen	Morgen
Morgenstern	Morgensterne
Moskito	Moskitos
Moslem	Moslems
Most	Moste
Motor	Motoren	Motore
Motorradfahrer	Motorradfahrer
Motorroller	Motorroller
Motorschaden	Motorschäden
Motorsport	—
Mount	Mounts
Mountainbiker	Mountainbiker
Mucks	Muckse
Mullah	Mullahs
Multi	Multis
Mundgeruch	Mundgerüche
Mundwinkel	Mundwinkel
Museumsdirektor	Museumsdirektoren
Musikant	Musikanten
Musiker	Musiker
Musikfreund	Musikfreunde
Musiklehrer	Musiklehrer
Musiksender	Musiksender
Musikstil	Musikstile
Musikunterricht	—
Musikverein	Musikvereine
Muskel	Muskeln
Muskelfaserriss	Muskelfaserrisse
Musketier	Musketiere
Muslim	Muslime
Musterprozess	Musterprozesse
Mut	—
Mutterkonzern	Mutterkonzerne
Mutterleib	—
Muttertag	Muttertage
Mythos	Mythen
Mädchenname	Mädchennamen
Märtyrer	Märtyrer
Möchtegern	Möchtegerne
Mönch	Mönche
Mörder	Mörder
Müll	—
Nabel	Nabel
Nachahmer	Nachahmer
Nachbar	Nachbarn
Nachbarort	Nachbarorte
Nachbarstaat	Nachbarstaaten
Nachbau	Nachbauten
Nachfahre	Nachfahren
Nachfolger	Nachfolger
Nachfolgestaat	Nachfolgestaaten
Nachholbedarf	Nachholbedarfe
Nachkomme	Nachkommen
Nachlass	Nachlasse
Nachmittag	Nachmittage
Nachname	Nachnamen
Nachrichtendienst	Nachrichtendienste
Nachrichtensender	Nachrichtensender
Nachruf	Nachrufe
Nachsatz	Nachsätze
Nachschlag	Nachschläge
Nachschub	Nachschübe
Nachteil	Nachteile
Nachthimmel	Nachthimmel
Nachtisch	Nachtische
Nachtrag	Nachträge
Nachtragshaushalt	Nachtragshaushalte
Nachweis	Nachweise
Nachwuchs	—
Nachwuchsspieler	Nachwuchsspieler
Nacken	Nacken
Nagel	Nägel
Nager	Nager
Nahverkehr	Nahverkehre
Nahversorger	Nahversorger
Name	Namen
Namensgeber	Namensgeber
Namenstag	Namenstage
Namensvetter	Namensvettern
Narr	Narren
Nationalcoach	Nationalcoachs	Nationalcoaches
Nationalfeiertag	Nationalfeiertage
Nationalheld	Nationalhelden
Nationalismus	Nationalismen
Nationalist	Nationalisten
Nationalpark	Nationalparks	Nationalparke	Nationalpärke
Nationalrat	Nationalräte
Nationalsozialismus	—
Nationalsozialist	Nationalsozialisten
Nationalspieler	Nationalspieler
Nationalstaat	Nationalstaaten
Nationaltrainer	Nationaltrainer
Naturfreund	Naturfreunde
Naturpark	Naturparks	Naturparke	Naturpärke
Naturschutz	—
Naturschutzbund	Naturschutzbünde
Naturwissenschaftler	Naturwissenschaftler
Navigator	Navigatoren
Nazi	Nazis
Neandertaler	Neandertaler
Nebel	Nebel
Nebeneffekt	Nebeneffekte
Nebenfluss	Nebenflüsse
Nebenjob	Nebenjobs
Nebenraum	Nebenräume
Neckar	—
Neffe	Neffen
Neger	Neger
Nehmer	Nehmer
Neid	Neide
Neider	Neider
Nenner	Nenner
Nennwert	Nennwerte
Neoliberalismus	—
Neonazi	Neonazis
Nerv	Nerven
Nervenkitzel	Nervenkitzel
Nervenzusammenbruch	Nervenzusammenbrüche
Nettogewinn	Nettogewinne
Nettolohn	Nettolöhne
Nettozahler	Nettozahler
Netzbetreiber	Netzbetreiber
Neuanfang	Neuanfänge
Neuaufbau	Neuaufbauten
Neubau	Neubauten
Neubauer	Neubauern
Neubeginn	Neubeginne
Neueinsteiger	Neueinsteiger
Neujahrsempfang	Neujahrsempfänge
Neujahrstag	Neujahrstage
Neuling	Neulinge
Neuner	Neuner
Neurologe	Neurologen
Neuschnee	—
Neustart	Neustarts
Neuwagen	Neuwagen	Neuwägen
Neuzugang	Neuzugänge
Newcomer	Newcomer
Newsletter	Newsletters	Newsletter
Newtonmeter	Newtonmeter
Nichtraucher	Nichtraucher
Niedergang	Niedergänge
Niederrhein	—
Niederschlag	Niederschläge
Nieselregen	Nieselregen
Nigerianer	Nigerianer
Nil	—
Nimbus	Nimbusse
Nippel	Nippel
Nix	Nixe
Nobelpreis	Nobelpreise
Nomade	Nomaden
Nonsens	—
Nord	Norde
Norden	—
Nordkoreaner	Nordkoreaner
Nordosten	—
Nordpol	Nordpole
Nordwesten	—
Normalfall	Normalfälle
Normalverbraucher	Normalverbraucher
Nostalgiker	Nostalgiker
Notar	Notare
Notarzt	Notärzte
Notarzthubschrauber	Notarzthubschrauber
Notarztwagen	Notarztwagen	Notarztwägen
Notausgang	Notausgänge
Notdienst	Notdienste
Notenbankchef	Notenbankchefs
Notfall	Notfälle
Notruf	Notrufe
Notstand	Notstände
November	November
Nullpunkt	Nullpunkte
Nulltarif	Nulltarife
Numerus	Numeri
Nuntius	Nuntien	Nuntii
Nussbaum	Nussbäume
Nutzen	Nutzen
Nutzer	Nutzer
Ob	—
Ober	Ober
Oberarm	Oberarme
Oberarzt	Oberärzte
Oberbefehlshaber	Oberbefehlshaber
Oberhirte	Oberhirten
Oberligist	Oberligisten
Oberrhein	—
Oberschenkel	Oberschenkel
Oberst	Oberste	Obersten
Oberstaatsanwalt	Oberstaatsanwälte
Oberstleutnant	Oberstleutnants
Oberteil	Oberteile
Obi	Obis
Obmann	Obmänner	Obleute
Obolus	Obolus	Obolusse
Obstbaum	Obstbäume
Ochs	Ochsen
Ochse	Ochsen
Odenwald	—
Ofen	Öfen
Offenbarungseid	Offenbarungseide
Offizier	Offiziere
Ohrring	Ohrringe
Ohrwurm	Ohrwürmer
Oktober	Oktober
Oldtimer	Oldtimer
Olymp	—
Olympiapark	—
Olympiasieg	Olympiasiege
Olympiasieger	Olympiasieger
Oman	—
Ombudsmann	Ombudsmänner	Ombudsleute
Omnibus	Omnibusse
Opa	Opas
Operationssaal	Operationssäle
Opernball	Opernbälle
Opportunismus	—
Oppositionspolitiker	Oppositionspolitiker
Optiker	Optiker
Optimismus	—
Optimist	Optimisten
Orangensaft	Orangensäfte
Orbit	Orbits
Orchestergraben	Orchestergräben
Orden	Orden	Örden
Ordinarius	Ordinarien
Ordner	Ordner
Organisator	Organisatoren
Organismus	Organismen
Organist	Organisten
Orgasmus	Orgasmen
Orient	—
Originaltitel	Originaltitel
Orkan	Orkane
Orlean	—
Ort	Orte
Ortsbeirat	Ortsbeiräte
Ortschef	Ortschefs
Ortseingang	Ortseingänge
Ortskern	Ortskerne
Ortsname	Ortsnamen
Ortsrand	Ortsränder
Ortsteil	Ortsteile
Ortstermin	Ortstermine
Ortsverband	Ortsverbände
Ortsverein	Ortsvereine
Ortsvorsteher	Ortsvorsteher
Oscar	Oscars
Ostblock	—
Osten	—
Osterhase	Osterhasen
Ostermontag	Ostermontage
Ostersonntag	Ostersonntage
Ostler	Ostler
Ostschweizer	Ostschweizer
Oststaat	Oststaaten
Ostteil	Ostteile
Output	Outputs
Overall	Overalls
Ozean	Ozeane
Ozon	—
Ozonwert	Ozonwerte
Pachtvertrag	Pachtverträge
Page	Pagen
Pakt	Pakte
Palast	Paläste
Palazzo	Palazzi
Palmengarten	Palmengärten
Panama	Panamas
Panda	Pandas
Panther	Panther
Pantoffel	Pantoffeln
Panzer	Panzer
Papa	Papas
Papagei	Papageis
Papi	Papis
Papierkorb	Papierkörbe
Papst	Päpste
Papstbesuch	Papstbesuche
Paradigmenwechsel	Paradigmenwechsel
Paragleiter	Paragleiter
Paragraf	Paragrafen
Paragraph	Paragraphen
Parameter	Parameter
Parasit	Parasiten
Parcours	Parcours
Pardon	—
Pariser	Pariser
Park	Parks
Parker	Parker
Parkplatz	Parkplätze
Parlamentarier	Parlamentarier
Parlamentarismus	—
Parlamentssitz	Parlamentssitze
Part	Parts
Parteiausschluss	Parteiausschlüsse
Parteichef	Parteichefs
Parteifreund	Parteifreunde
Parteigenosse	Parteigenossen
Parteikollege	Parteikollegen
Parteiobmann	Parteiobmänner	Parteiobleute
Parteitag	Parteitage
Parteivorsitz	Parteivorsitze
Parteivorstand	Parteivorstände
Partner	Partner
Pas	Pas
Passagier	Passagiere
Passant	Passanten
Passat	Passate
Passer	Passer
Passus	Passus
Pastor	Pastoren	Pastore	Pastöre
Pater	Patres
Patient	Patienten
Patriarch	Patriarchen
Patriotismus	Patriotismen
Patron	Patrone
Patzer	Patzer
Paukenschlag	Paukenschläge
Pavillon	Pavillons
Pazifik	—
Pazifismus	—
Pazifist	Pazifisten
Pechstein	—
Pechvogel	Pechvögel
Pegasus	—
Pegel	Pegel
Pegelstand	Pegelstände
Peiniger	Peiniger
Pelz	Pelze
Penalty	Penaltys
Pendler	Pendler
Penis	Penisse	Penes
Penner	Penner
Penny	Pennys	Pence
Pensionist	Pensionisten
Pensionsanspruch	Pensionsansprüche
Perser	Perser
Personalabbau	—
Personalaufwand	Personalaufwände
Personalausweis	Personalausweise
Personalbestand	Personalbestände
Personalchef	Personalchefs
Personalmangel	Personalmängel
Personalrat	Personalräte
Personenkreis	Personenkreise
Personennahverkehr	Personennahverkehre
Personenschaden	Personenschäden
Personenverkehr	—
Personenwagen	Personenwagen	Personenwägen
Personenzug	Personenzüge
Peso	Peso	Pesos
Pessimismus	—
Pessimist	Pessimisten
Petitionsausschuss	Petitionsausschüsse
Pfad	Pfade
Pfadfinder	Pfadfinder
Pfahl	Pfähle
Pfandbrief	Pfandbriefe
Pfarrer	Pfarrer
Pfarrgemeinderat	Pfarrgemeinderäte
Pfarrsaal	Pfarrsäle
Pfau	Pfauen	Pfaue
Pfeffer	Pfeffer
Pfefferspray	Pfeffersprays
Pfeil	Pfeile
Pfeiler	Pfeiler
Pfennig	Pfennige
Pferdesport	—
Pfiff	Pfiffe
Pfingstmontag	Pfingstmontage
Pfingstsonntag	Pfingstsonntage
Pfirsich	Pfirsiche
Pflanzenschutz	—
Pflasterstein	Pflastersteine
Pflegedienst	Pflegedienste
Pflegefall	Pflegefälle
Pfleger	Pfleger
Pflug	Pflüge
Pfosten	Pfosten
Pförtner	Pförtner
Pharmakonzern	Pharmakonzerne
Philharmoniker	Philharmoniker
Philologe	Philologen
Philosoph	Philosophen
Physiker	Physiker
Physiotherapeut	Physiotherapeuten
Pianist	Pianisten
Pichler	Pichlers	Pichler
Pickel	Pickel
Pieper	Pieper
Pier	Piere
Pietsch	Pietsche
Pilger	Pilger
Piller	Piller
Pilot	Piloten
Pilotversuch	Pilotversuche
Pilz	Pilze
Pin	Pins
Pinguin	Pinguine
Pinsel	Pinsel
Pinselstrich	Pinselstriche
Pionier	Pioniere
Pirat	Piraten
Pitbull	Pitbulls
Plan	Pläne
Planer	Planer
Planet	Planeten
Planfeststellungsbeschluss	Planfeststellungsbeschlüsse
Plastiksack	Plastiksäcke
Plattenbau	Plattenbauten
Plattenspieler	Plattenspieler
Platz	Plätze
Platzhirsch	Platzhirsche
Platzmangel	Platzmängel
Platzverweis	Platzverweise
Plausch	Plausche	Pläusche
Playboy	Playboys
Player	Player
Plenarsaal	Plenarsäle
Plot	Plots
Pluralismus	—
Pluspunkt	Pluspunkte
Pneu	Pneus
Podest	Podeste
Podestplatz	Podestplätze
Poet	Poeten
Pogrom	Pogrome
Pokal	Pokale
Pokalsieger	Pokalsieger
Poker	—
Pole	Polen
Politiker	Politiker
Politikwissenschaftler	Politikwissenschaftler
Politologe	Politologen
Polizeibericht	Polizeiberichte
Polizeichef	Polizeichefs
Polizeidienst	Polizeidienste
Polizeieinsatz	Polizeieinsätze
Polizeigewahrsam	—
Polizeiposten	Polizeiposten
Polizeischutz	Polizeischutze
Polizeisprecher	Polizeisprecher
Polizist	Polizisten
Pollen	Pollen
Poller	Poller
Polster	Polster
Pommer	Pommer
Pomp	—
Pony	Ponys
Pop	—
Popo	Popos
Popsong	Popsongs
Popstar	Popstars
Populismus	—
Populist	Populisten
Porno	Pornos
Port	Porte
Porter	Porter
Portier	Portiers
Portugiese	Portugiesen
Posaunenchor	Posaunenchöre
Posaunist	Posaunisten
Post	Posten
Postbote	Postboten
Posten	Posten
Poster	Poster
Postler	Postler
Pott	Pötte
Pragmatiker	Pragmatiker
Pragmatismus	—
Praktikant	Praktikanten
Praktiker	Praktiker
Pranger	Pranger
Prater	—
Prediger	Prediger
Preis	Preise
Preisanstieg	Preisanstiege
Preisdruck	Preisdruck
Preiskampf	Preiskämpfe
Preisnachlass	Preisnachlasse	Preisnachlässe
Preisrichter	Preisrichter
Preisunterschied	Preisunterschiede
Preisverfall	Preisverfälle
Preisvergleich	Preisvergleiche
Preisvorteil	Preisvorteile
Premier	Premiers
Premierminister	Premierminister
Pressebericht	Presseberichte
Pressechef	Pressechefs
Pressedienst	Pressedienste
Presserat	Presseräte
Pressesprecher	Pressesprecher
Pressewart	Pressewarte
Priester	Priester
Primar	Primare
Primarius	Primarien
Primus	Primi	Primusse
Prinz	Prinzen
Prior	Prioren
Privatanleger	Privatanleger
Privatbesitz	Privatbesitze
Privatdetektiv	Privatdetektive
Privatdozent	Privatdozenten
Privathaushalt	Privathaushalte
Privatkunde	Privatkunden
Privatmann	Privatmänner	Privatleute
Privatsender	Privatsender
Prix	Prixs
Proband	Probanden
Probebetrieb	Probebetriebe
Probelauf	Probeläufe
Problemfall	Problemfälle
Produktionsstandort	Produktionsstandorte
Produzent	Produzenten
Professional	Professionals
Professor	Professoren
Profi	Profis
Profit	Profite
Profiteur	Profiteure
Programmdirektor	Programmdirektoren
Programmierer	Programmierer
Programmpunkt	Programmpunkte
Projektentwickler	Projektentwickler
Projektleiter	Projektleiter
Projektor	Projektoren
Prokurist	Prokuristen
Prolog	Prologe
Promoter	Promoter
Propagandist	Propagandisten
Propeller	Propeller
Prophet	Propheten
Proporz	Proporze
Prospekt	Prospekte
Protagonist	Protagonisten
Protektionismus	—
Protest	Proteste
Protestant	Protestanten
Protestantismus	—
Protestmarsch	Protestmärsche
Prototyp	Prototypen
Provider	Provider
Provokateur	Provokateure
Prozentpunkt	Prozentpunkte
Prozentsatz	Prozentsätze
Prozess	Prozesse
Prozessbeginn	Prozessbeginne
Prozessor	Prozessoren
Prozesstag	Prozesstage
Präfekt	Präfekten
Präsident	Präsidenten
Psalm	Psalmen
Psychiater	Psychiater
Psychoanalytiker	Psychoanalytiker
Psychologe	Psychologen
Psychopath	Psychopathen
Psychotherapeut	Psychotherapeuten
Pub	Pubs
Publikumsliebling	Publikumslieblinge
Publikumsmagnet	Publikumsmagnete	Publikumsmagneten
Publizist	Publizisten
Puck	Pucks
Pudding	Puddinge
Pudel	Pudel
Puder	Puder
Puffer	Puffer
Pulli	Pullis
Pullover	Pullover
Pulp	Pulpen
Puls	Pulse
Puma	Pumas
Punk	Punks
Punker	Punker
Punkrock	—
Punkt	Punkte
Punktgewinn	Punktgewinne
Punktverlust	Punktverluste
Punsch	Punsche
Purist	Puristen
Putsch	Putsche
Putschist	Putschisten
Putschversuch	Putschversuche
Putz	Putze
Python	Pythons
Pöbel	—
Quadratkilometer	Quadratkilometer
Quadratmeter	Quadratmeter
Quadratmeterpreis	Quadratmeterpreise
Qualm	—
Quantensprung	Quantensprünge
Quarterback	Quarterbacks
Quast	Quaste
Quatsch	—
Quell	Quelle
Querdenker	Querdenker
Quereinsteiger	Quereinsteiger
Querschnitt	Querschnitte
Rabatt	Rabatte
Rabbi	Rabbinen	Rabbis
Rabbiner	Rabbiner
Rabe	Raben
Racheakt	Racheakte
Rachen	Rachen
Radar	Radare	Radars
Radfahrer	Radfahrer
Radiosender	Radiosender
Radius	Radien
Radprofi	Radprofis
Radsport	Radsporte
Radsportler	Radsportler
Radstand	Radstände
Radweg	Radwege
Rahmen	Rahmen
Rain	Raine
Raketenangriff	Raketenangriffe
Ramadan	Ramadane
Rambo	Rambos
Rand	Randen
Randal	Randale
Randalierer	Randalierer
Rang	Ränge
Range	Rangen
Ranger	Ranger
Rank	Ränke
Rap	Raps
Rapp	Rapps
Rappen	Rappen
Rapper	Rapper
Rapport	Rapporte
Raps	Rapse
Rasen	Rasen
Rasenplatz	Rasenplätze
Rasiermesser	Rasiermesser
Rassismus	Rassismen
Rassist	Rassisten
Rastplatz	Rastplätze
Rat	Räte
Ratgeber	Ratgeber
Rathauschef	Rathauschefs
Ratschlag	Ratschläge
Ratsherr	Ratsherren
Raub	Raube
Raubbau	—
Raubmord	Raubmorde
Raubzug	Raubzüge
Raubüberfall	Raubüberfälle
Raucher	Raucher
Raum	Räume
Rausch	Räusche
Rauscher	Rauschers	Rauscher
Rausschmiss	Rausschmisse
Rauswurf	Rauswürfe
Rave	Raves
Reaktor	Reaktoren
Realismus	Realismen
Realist	Realisten
Realo	Realos
Rebell	Rebellen
Rebstock	Rebstöcke
Rechenschaftsbericht	Rechenschaftsberichte
Rechner	Rechner
Rechnungsabschluss	Rechnungsabschlüsse
Rechnungshof	Rechnungshöfe
Rechtsanspruch	Rechtsansprüche
Rechtsanwalt	Rechtsanwälte
Rechtsausschuss	Rechtsausschüsse
Rechtsbruch	Rechtsbrüche
Rechtsexperte	Rechtsexperten
Rechtsextremismus	—
Rechtsextremist	Rechtsextremisten
Rechtspopulist	Rechtspopulisten
Rechtsradikalismus	Rechtsradikalismen
Rechtsruck	Rechtsrucke
Rechtsschutz	—
Rechtsstaat	Rechtsstaaten
Rechtsstreit	Rechtsstreite
Rechtsvertreter	Rechtsvertreter
Rechtsweg	Rechtswege
Recke	Recken
Redakteur	Redakteure
Redaktionsschluss	Redaktionsschlüsse
Redaktor	Redaktoren
Redner	Redner
Reeder	Reeder
Referatsleiter	Referatsleiter
Referee	Referees
Referendar	Referendare
Referent	Referenten
Referenzkurs	Referenzkurse
Reflex	Reflexe
Reformator	Reformatoren
Reformer	Reformer
Reformkurs	Reformkurse
Reformplan	Reformpläne
Reformprozess	Reformprozesse
Reformstaat	Reformstaaten
Reformvorschlag	Reformvorschläge
Refrain	Refrains
Regelfall	Regelfälle
Regen	Regen	Regen
Regenbogen	Regenbogen
Regenfall	Regenfälle
Regenguss	Regengüsse
Regenmantel	Regenmäntel
Regenschauer	Regenschauer
Regenschirm	Regenschirme
Regent	Regenten
Regenwald	Regenwälder
Reggae	—
Regierungsbezirk	Regierungsbezirke
Regierungschef	Regierungschefs
Regierungskreis	Regierungskreise
Regierungsrat	Regierungsräte
Regierungssitz	Regierungssitze
Regierungssprecher	Regierungssprecher
Regierungsvertreter	Regierungsvertreter
Regierungswechsel	Regierungswechsel
Regimegegner	Regimegegner
Regimekritiker	Regimekritiker
Regionalligist	Regionalligisten
Regionalverband	Regionalverbände
Regionalverkehr	Regionalverkehre
Regionalzug	Regionalzüge
Regisseur	Regisseure
Reichskanzler	Reichskanzler
Reichstag	Reichstage
Reichtum	Reichtümer
Reifen	Reifen
Reigen	Reigen
Reimer	Reimer
Reingewinn	Reingewinne
Reisebericht	Reiseberichte
Reisebus	Reisebusse
Reiseleiter	Reiseleiter
Reisende	Reisenden
Reisepass	Reisepässe
Reiseveranstalter	Reiseveranstalter
Reiseverkehr	—
Reiz	Reize
Rekord	Rekorde
Rekordhalter	Rekordhalter
Rekordmeister	Rekordmeister
Rekrut	Rekruten
Rektor	Rektoren
Rekurs	Rekurse
Religionslehrer	Religionslehrer
Religionsunterricht	—
Renner	Renner
Rennfahrer	Rennfahrer
Rennsport	—
Rennstall	Rennställe
Renntag	Renntage
Rennwagen	Rennwagen	Rennwägen
Rentenanspruch	Rentenansprüche
Rentenbeitrag	Rentenbeiträge
Rentenmarkt	Rentenmärkte
Rentner	Rentner
Rep	Reps
Report	Reporte
Reporter	Reporter
Repräsentant	Repräsentanten
Republikaner	Republikaner
Reservist	Reservisten
Resolutionsentwurf	Resolutionsentwürfe
Respekt	—
Ressortchef	Ressortchefs
Rest	Reste
Restaurator	Restauratoren
Retter	Retter
Rettungsdienst	Rettungsdienste
Rettungshubschrauber	Rettungshubschrauber
Rettungsversuch	Rettungsversuche
Rettungswagen	Rettungswagen	Rettungswägen
Revisor	Revisoren
Revolver	Revolver
Rezensent	Rezensenten
Rezeptor	Rezeptoren
Rhein	—
Rheingau	—
Rhythmus	Rhythmen
Richter	Richter
Richterspruch	Richtersprüche
Richtwert	Richtwerte
Riegel	Riegel
Riemer	Riemer
Riese	Riesen
Riesenerfolg	Riesenerfolge
Riesenslalom	Riesenslaloms
Riesenspaß	Riesenspäße
Riesentorlauf	Riesentorläufe
Riesling	Rieslinge
Rinderwahn	—
Rinderwahnsinn	—
Ring	Ringe
Ringer	Ringer
Risikofaktor	Risikofaktoren
Riss	Risse
Rist	Riste
Ritt	Ritte
Ritter	Ritter
Ritus	Riten
Ritz	Ritze
Rivale	Rivalen
Roadster	Roadster
Robinson	Robinsons
Roboter	Roboter
Rock	Röcke
Rocker	Rocker
Rockmusiker	Rockmusiker
Rockstar	Rockstare
Rodler	Rodler
Rogner	Rogner
Rohbau	Rohbauten
Rohstoff	Rohstoffe
Rohstoffpreis	Rohstoffpreise
Roller	Roller
Rollstuhl	Rollstühle
Rollstuhlfahrer	Rollstuhlfahrer
Roman	Romane
Romancier	Romanciers
Romane	Romanen
Romantiker	Romantiker
Romeo	Romeos
Rosengarten	Rosengärten
Rosenkranz	Rosenkränze
Rosenmontag	Rosenmontage
Rotstift	Rotstifte
Rottweiler	Rottweiler
Rotwein	Rotweine
Routinier	Routiniers
Rowdy	Rowdys
Rubel	Rubel
Rubin	Rubine
Ruch	—
Ruck	Rucke
Rucksack	Rucksäcke
Ruderer	Ruderer
Rudolph	Rudolphs
Ruf	Rufe
Rufer	Rufer
Ruhestand	Ruhestanden
Ruhetag	Ruhetage
Ruhm	Ruhme
Ruin	—
Rum	Rums	Rume
Rumpf	Rümpfe
Run	Runs
Rundflug	Rundflüge
Rundfunk	—
Rundfunkrat	Rundfunkräte
Rundfunksender	Rundfunksender
Rundgang	Rundgänge
Rundkurs	Rundkurse
Rundumschlag	Rundumschläge
Rusch	Rusche
Russe	Russen
Ruß	Ruße
Rächer	Rächer
Räuber	Räuber
Rücken	Rücken
Rückruf	Rückrufe
Rückschlag	Rückschläge
Rückstand	Rückstanden
Rüssel	Rüssel
Saal	Säle
Saalbau	Saalbauten
Sabbat	Sabbate
Sachbearbeiter	Sachbearbeiter
Sachpreis	Sachpreise
Sachschaden	Sachschäden
Sachse	Sachsen
Sachverhalt	Sachverhalte
Sachverstand	—
Sachzwang	Sachzwänge
Sack	Säcke
Safe	Safes
Saft	Säfte
Saisonauftakt	Saisonauftakte
Saisonbeginn	Saisonbeginne
Saisonsieg	Saisonsiege
Saisonstart	Saisonstarts	Saisonstarte
Saisontreffer	Saisontreffer
Sakko	Sakkos
Salamander	Salamander
Salami	Salamis
Salat	Salate
Saldo	Salden	Saldos	Saldi
Salon	Salons
Salto	Saltos
Samariter	Samariter
Samba	Sambas
Same	Samen
Samen	Samen
Sammelband	Sammelbände
Sammler	Sammler
Sampler	Sampler
Samstag	Samstage
Samstagabend	Samstagabende
Samstagmorgen	Samstagmorgen
Samstagnachmittag	Samstagnachmittage
Samt	Samte
Samurai	Samurai	Samurais
Sand	Sanden
Sander	Sander
Sandkasten	Sandkästen	Sandkasten
Sandler	Sandler
Sandplatz	Sandplätze
Sandsack	Sandsäcke
Sandstein	Sandsteine
Sandstrand	Sandstrände
Sandwich	Sandwichs	Sandwiches	Sandwiche
Sanierer	Sanierer
Sanierungsfall	Sanierungsfälle
Sanierungsplan	Sanierungspläne
Sarg	Särge
Sarkasmus	Sarkasmen
Sarkophag	Sarkophage
Satan	Satane
Satellit	Satelliten
Satiriker	Satiriker
Sattel	Sättel
Sattelschlepper	Sattelschlepper
Sattelzug	Sattelzüge
Sattler	Sattler
Satz	Sätze
Saubermann	Saubermänner
Saudi	Saudis
Sauerstoff	—
Saurier	Saurier
Scanner	Scanner
Schachspieler	Schachspieler
Schacht	Schächte
Schachzug	Schachzüge
Schade	Schäden
Schaden	Schaden
Schadenersatz	—
Schadenersatzanspruch	Schadenersatzansprüche
Schadensersatz	—
Schadensfall	Schadensfälle
Schadstoff	Schadstoffe
Schaffner	Schaffner
Schah	Schahs
Schal	Schals
Schalk	Schalke	Schälke
Schall	Schalle	Schälle
Schalldämpfer	Schalldämpfer
Schalter	Schalter
Schamane	Schamanen
Schandfleck	Schandflecke	Schandflecken
Scharfschütze	Scharfschützen
Schatten	Schatten
Schatz	Schätze
Schatzkanzler	Schatzkanzler
Schatzmeister	Schatzmeister
Schaub	Schäube
Schauder	Schauder
Schaukasten	Schaukästen	Schaukasten
Schaum	Schäume
Schauplatz	Schauplätze
Schauprozess	Schauprozesse
Schauspieler	Schauspieler
Schausteller	Schausteller
Scheck	Schecks
Scheibenwischer	Scheibenwischer
Scheich	Scheichs	Scheiche
Scheideweg	Scheidewege
Schein	Scheine
Scheinwerfer	Scheinwerfer
Scheitel	Scheitel
Scheiterhaufen	Scheiterhaufen
Scheißdreck	Scheißdrecke
Schelm	Schelme
Schenk	Schenken
Schenkel	Schenkel
Schenker	Schenker
Scherben	—
Scherbenhaufen	Scherbenhaufen
Scherer	Scherers	Scherer
Scherge	Schergen
Scherz	Scherze
Schi	Schis
Schick	—
Schicksalsschlag	Schicksalsschläge
Schieber	Schieber
Schiedsrichter	Schiedsrichter
Schienenverkehr	Schienenverkehre
Schießstand	Schießstanden
Schiffbau	—
Schiffbruch	Schiffbrüche
Schiffer	Schiffer
Schiit	Schiiten
Schilcher	Schilcher
Schild	Schilde
Schill	Schille
Schilling	Schilling	Schillinge
Schimmel	Schimmel
Schimmer	Schimmer
Schimpanse	Schimpansen
Schinken	Schinken
Schiri	Schiris
Schirm	Schirme
Schirmer	Schirmer
Schirmherr	Schirmherren
Schlachthof	Schlachthöfe
Schlachtruf	Schlachtrufe
Schlafplatz	Schlafplätze
Schlafsack	Schlafsäcke
Schlag	Schläge
Schlagabtausch	—
Schlaganfall	Schlaganfälle
Schlager	Schlager
Schlagstock	Schlagstöcke
Schlagzeuger	Schlagzeuger
Schlamassel	Schlamassel
Schlamm	Schlämme	Schlamme
Schlauch	Schläuche
Schleicher	Schleicher
Schleichweg	Schleichwege
Schleier	Schleier
Schlepper	Schlepper
Schleuser	Schleuser
Schlich	Schliche
Schlichter	Schlichter
Schlick	Schlicke
Schlips	Schlipse
Schlitten	Schlitten
Schlittschuh	Schlittschuhe
Schlitz	Schlitze
Schlosser	Schlosser
Schlosshof	Schlosshöfe
Schlosspark	Schlossparks	Schlossparke	Schlosspärke
Schluck	Schlucke	Schlücke	Schluck
Schluss	Schlüsse
Schlussmann	Schlussmänner	Schlussleute
Schlusspfiff	Schlusspfiffe
Schlusspunkt	Schlusspunkte
Schlussrang	Schlussränge
Schlussspurt	Schlussspurts	Schlussspurte
Schlussstrich	Schlussstriche
Schlusstag	Schlusstage
Schlussverkauf	Schlussverkäufe
Schlächter	Schlächter
Schläger	Schläger
Schlüpfer	Schlüpfer
Schlüssel	Schlüssel
Schlüsselbund	Schlüsselbunde
Schmelz	Schmelze
Schmerz	Schmerzen
Schmetterling	Schmetterlinge
Schmied	Schmiede
Schmuck	Schmucke
Schmuggel	—
Schmuggler	Schmuggler
Schmutz	—
Schnabel	Schnäbel
Schnappschuss	Schnappschüsse
Schnaps	Schnäpse
Schnee	Schneen
Schneefall	Schneefälle
Schneemann	Schneemänner
Schneesturm	Schneestürme
Schneid	—
Schneider	Schneider
Schnellschuss	Schnellschüsse
Schnellzug	Schnellzüge
Schnickschnack	—
Schnitt	Schnitte
Schnittpunkt	Schnittpunkte
Schnitzer	Schnitzer
Schnupfen	Schnupfen
Schnurrbart	Schnurrbärte
Schnüffler	Schnüffler
Schober	Schober
Schokoriegel	Schokoriegel
Schopf	Schöpfe
Schornstein	Schornsteine
Schotte	Schotten
Schotter	Schotter
Schrank	Schränke
Schranz	Schränze
Schraubenschlüssel	Schraubenschlüssel
Schraubenzieher	Schraubenzieher
Schrebergarten	Schrebergärten
Schreck	Schrecke
Schrecken	Schrecken
Schrei	Schreie
Schreiber	Schreiber
Schreibtisch	Schreibtische
Schreier	Schreier
Schrein	Schreine
Schreiner	Schreiner
Schriftsteller	Schriftsteller
Schriftstellerverband	Schriftstellerverbände
Schriftzug	Schriftzüge
Schritt	Schritte
Schrittmacher	Schrittmacher
Schrott	Schrotte
Schub	Schübe
Schuft	Schufte
Schuh	Schuhe
Schuhmacher	Schuhmacher
Schulabschluss	Schulabschlüsse
Schulalltag	Schulalltage
Schulbeginn	Schulbeginne
Schulbesuch	Schulbesuche
Schulbetrieb	Schulbetriebe
Schulbus	Schulbusse
Schuldenabbau	—
Schuldenberg	Schuldenberge
Schuldendienst	Schuldendienste
Schuldenerlass	Schuldenerlasse	Schuldenerlässe
Schuldenstand	Schuldenstände
Schuldienst	Schuldienste
Schuldirektor	Schuldirektoren
Schuldner	Schuldner
Schuldspruch	Schuldsprüche
Schulfreund	Schulfreunde
Schulhof	Schulhöfe
Schulleiter	Schulleiter
Schulrat	Schulräte
Schulschluss	Schulschlüsse
Schulsport	—
Schultag	Schultage
Schulterschluss	Schulterschlüsse
Schultyp	Schultypen
Schulunterricht	—
Schulversuch	Schulversuche
Schulweg	Schulwege
Schulze	Schulzen
Schuppen	Schuppen
Schurke	Schurken
Schuss	Schüsse
Schusswechsel	Schusswechsel
Schuster	Schuster
Schutt	—
Schutz	Schutze
Schutzengel	Schutzengel
Schutzpatron	Schutzpatrone
Schutzraum	Schutzräume
Schutzschild	Schutzschilde
Schutzwall	Schutzwälle
Schwachkopf	Schwachköpfe
Schwachpunkt	Schwachpunkte
Schwachsinn	—
Schwager	Schwäger
Schwaiger	Schwaiger
Schwamm	Schwämme
Schwan	Schwäne
Schwangerschaftsabbruch	Schwangerschaftsabbrüche
Schwank	Schwänke
Schwanz	Schwänze
Schwarm	Schwärme
Schwarzarbeiter	Schwarzarbeiter
Schwarzer	Schwarzers	Schwarzer
Schwarzfahrer	Schwarzfahrer
Schwarzmarkt	Schwarzmärkte
Schwarzwald	—
Schwede	Schweden
Schwefel	—
Schweiger	Schweiger
Schweizer	Schweizer
Schwerpunkt	Schwerpunkte
Schwertkämpfer	Schwertkämpfer
Schwerverbrecher	Schwerverbrecher
Schwerverkehr	—
Schwiegersohn	Schwiegersöhne
Schwiegervater	Schwiegerväter
Schwierigkeitsgrad	Schwierigkeitsgrade
Schwimmer	Schwimmer
Schwindel	Schwindel
Schwindler	Schwindler
Schwinger	Schwinger
Schwund	—
Schwung	Schwünge
Schwur	Schwüre
Schwächling	Schwächlinge
Schwätzer	Schwätzer
Schädel	Schädel
Schönheitssalon	Schönheitssalons
Schönling	Schönlinge
Schöpfer	Schöpfer
Schüler	Schüler
Schürzenjäger	Schürzenjäger
Schützengraben	Schützengräben
Scientologe	Scientologen
Scout	Scouts
Screen	Screens
Sechser	Sechser
Sechstel	Sechstel
Sechszylinder	Sechszylinder
See	Seen
Seefahrer	Seefahrer
Seehund	Seehunde
Seelenklempner	Seelenklempner
Seelsorger	Seelsorger
Seemann	Seeleute
Segen	Segen
Segler	Segler
Seher	Seher
Seiler	Seiler
Seitenblick	Seitenblicke
Seitenhieb	Seitenhiebe
Seitensprung	Seitensprünge
Seitenwechsel	Seitenwechsel
Sekretär	Sekretäre
Sekt	Sekte
Sektionschef	Sektionschefs
Sektor	Sektoren
Selbstbehalt	Selbstbehalte
Selbstmord	Selbstmorde
Selbstmordanschlag	Selbstmordanschläge
Selbstmordversuch	Selbstmordversuche
Selbstschutz	Selbstschutze
Selbstzweck	Selbstzwecke
Selbstzweifel	Selbstzweifel
Seminarraum	Seminarräume
Senat	Senate
Senator	Senatoren
Senatsbeschluss	Senatsbeschlüsse
Senatssprecher	Senatssprecher
Sendemast	Sendemaste	Sendemasten
Sendeplatz	Sendeplätze
Sender	Sender
Sendling	Sendlinge
Senf	Senfe
Senior	Senioren
Senn	Senne
Sensor	Sensoren
Separatist	Separatisten
September	September
Serbe	Serben
Serge	Sergen
Sergeant	Sergeanten	Sergeants
Serienmörder	Serienmörder
Server	Server
Sessel	Sessel
Sessellift	Sessellifte
Seufzer	Seufzer
Sex	—
Shareholder	Shareholders
Sheriff	Sheriffs
Shop	Shops
Showdown	Showdowns
Showmaster	Showmaster
Shuttle	Shuttles
Sicherheitsabstand	Sicherheitsabstände
Sicherheitsberater	Sicherheitsberater
Sicherheitschef	Sicherheitschefs
Sicherheitsdienst	Sicherheitsdienste
Sicherheitsexperte	Sicherheitsexperten
Sicherheitsgurt	Sicherheitsgurte
Sicherheitsmangel	Sicherheitsmängel
Sicherheitsrat	Sicherheitsräte
Sicherheitsstandard	Sicherheitsstandards
Sichtkontakt	Sichtkontakte
Siebenmeter	Siebenmeter
Siedler	Siedler
Sieger	Sieger
Siegerpodest	Siegerpodeste
Siegeszug	Siegeszüge
Siegtreffer	Siegtreffer
Silk	—
Silo	Silos
Sims	Simse
Simulator	Simulatoren
Sinai	—
Singkreis	Singkreise
Sinn	Sinne
Sinneswandel	Sinneswandel
Sinto	Sinti
Sir	Sirs
Sirup	Sirupe
Sitz	Sitze
Sitzplatz	Sitzplätze
Sitzungssaal	Sitzungssäle
Ska	—
Skandal	Skandale
Skandinavier	Skandinavier
Skat	Skats	Skate
Skeptiker	Skeptiker
Sketch	Sketche
Ski	Skis
Skifahrer	Skifahrer
Skilehrer	Skilehrer
Skilift	Skilifte
Skinhead	Skinheads
Skipass	Skipässe
Skisport	Skisporte
Skispringer	Skispringer
Skiunfall	Skiunfälle
Sklave	Sklaven
Skorpion	Skorpione
Slalom	Slaloms
Slapstick	Slapsticks
Slip	Slips
Slogan	Slogans
Slowake	Slowaken
Slowene	Slowenen
Slum	Slums
Smog	Smogs
Smoking	Smokings	Smokinge
Snowboarder	Snowboarder
Sockel	Sockel
Socken	Socken
Softwarehersteller	Softwarehersteller
Softwarekonzern	Softwarekonzerne
Sog	Soge
Sohn	Söhne
Solarstrom	—
Sold	Solde
Soldat	Soldaten
Solidarpakt	Solidarpakte
Solist	Solisten
Sommer	Sommer
Sommerabend	Sommerabende
Sommermonat	Sommermonate
Sommernachtstraum	Sommernachtsträume
Sommertag	Sommertage
Sommerurlaub	Sommerurlaube
Sonderermittler	Sonderermittler
Sonderfall	Sonderfälle
Sondergipfel	Sondergipfel
Sonderparteitag	Sonderparteitage
Sonderpreis	Sonderpreise
Sonderstatus	Sonderstatus
Sonderweg	Sonderwege
Sonderzug	Sonderzüge
Song	Songs
Songwriter	Songwriter
Sonnabend	Sonnabende
Sonnenaufgang	Sonnenaufgänge
Sonnenbrand	Sonnenbranden
Sonnenkollektor	Sonnenkollektoren
Sonnenschein	—
Sonnenschirm	Sonnenschirme
Sonnenstrahl	Sonnenstrahlen
Sonnenuntergang	Sonnenuntergänge
Sonntag	Sonntage
Sonntagabend	Sonntagabende
Sonntagmorgen	Sonntagmorgen
Sonntagnachmittag	Sonntagnachmittage
Sonntagvormittag	Sonntagvormittage
Sopran	Soprane
Soul	—
Sound	Sounds
Soundcheck	Soundchecks
Soundtrack	Soundtracks
Sowjet	Sowjets
Sozialabbau	—
Sozialarbeiter	Sozialarbeiter
Sozialdemokrat	Sozialdemokraten
Sozialexperte	Sozialexperten
Sozialismus	Sozialismen
Sozialist	Sozialisten
Sozialminister	Sozialminister
Sozialpartner	Sozialpartner
Sozialplan	Sozialpläne
Sozialpolitiker	Sozialpolitiker
Sozialstaat	Sozialstaaten
Sozialversicherungsbeitrag	Sozialversicherungsbeiträge
Sozialwissenschaftler	Sozialwissenschaftler
Soziologe	Soziologen
Spalt	Spalte
Spanier	Spanier
Spanner	Spanner
Spannungsbogen	Spannungsbogen	Spannungsbögen
Sparer	Sparer
Spargel	Spargel	Spargeln
Sparkurs	Sparkurse
Sparplan	Sparpläne
Sparzwang	Sparzwänge
Spaten	Spaten
Spatenstich	Spatenstiche
Spatz	Spatzen
Spaziergang	Spaziergänge
Spaß	Späße
Spaßvogel	Spaßvögel
Specht	Spechte
Speck	Specke
Spediteur	Spediteure
Speer	Speere
Speichel	—
Speicher	Speicher
Speiseplan	Speisepläne
Speisesaal	Speisesäle
Spekulant	Spekulanten
Spender	Spender
Spengler	Spengler
Sperling	Sperlinge
Spessart	—
Spezialist	Spezialisten
Spider	Spiders
Spiegel	Spiegel
Spielautomat	Spielautomaten
Spielball	Spielbälle
Spielbeginn	—
Spielbetrieb	Spielbetriebe
Spieler	Spieler
Spielertrainer	Spielertrainer
Spielfeldrand	Spielfeldränder
Spielfilm	Spielfilme
Spielleiter	Spielleiter
Spielmacher	Spielmacher
Spielort	Spielorte
Spielplan	Spielpläne
Spielplatz	Spielplätze
Spielraum	Spielräume
Spielstand	Spielstände
Spieltag	Spieltage
Spielverderber	Spielverderber
Spielverlauf	Spielverläufe
Spielzug	Spielzüge
Spieß	Spieße
Spike	Spikes
Spin	Spins
Spinat	Spinate
Spind	Spinde
Spinner	Spinner
Spion	Spione
Spirit	Spirits
Spital	Spitäler
Spitz	Spitze
Spitzel	Spitzel
Spitzenkandidat	Spitzenkandidaten
Spitzenklub	Spitzenklubs
Spitzenmanager	Spitzenmanager
Spitzenplatz	Spitzenplätze
Spitzenpolitiker	Spitzenpolitiker
Spitzenreiter	Spitzenreiter
Spitzenspieler	Spitzenspieler
Spitzensport	—
Spitzensportler	Spitzensportler
Spitzensteuersatz	Spitzensteuersätze
Spitzenverband	Spitzenverbände
Spitzenverdiener	Spitzenverdiener
Spitzenwert	Spitzenwerte
Spitzer	Spitzer
Spitzname	Spitznamen
Splitter	Splitter
Sponsor	Sponsoren
Sporn	Sporen	Sporne
Sport	Sporte
Sportartikel	Sportartikel
Sportbund	Sportbunde	Sportbünde
Sportdirektor	Sportdirektoren
Sportfreund	Sportfreunde
Sportklub	Sportklubs
Sportlehrer	Sportlehrer
Sportler	Sportler
Sportplatz	Sportplätze
Sportunterricht	Sportunterrichte
Sportverband	Sportverbände
Sportverein	Sportvereine
Sportwagen	Sportwagen	Sportwägen
Sportwart	Sportwarte
Spot	Spots
Spott	—
Sprachgebrauch	Sprachgebräuche
Sprachkurs	Sprachkurse
Sprachraum	Sprachräume
Spray	Sprays
Sprayer	Sprayer
Sprechchor	Sprechchöre
Sprecher	Sprecher
Sprengel	Sprengel
Sprenger	Sprenger
Sprengkopf	Sprengköpfe
Sprengkörper	Sprengkörper
Sprengsatz	Sprengsätze
Sprengstoff	Sprengstoffe
Sprengstoffanschlag	Sprengstoffanschläge
Springer	Springer
Springreiter	Springreiter
Sprint	Sprints
Sprinter	Sprinter
Sprit	Sprite
Spross	Sprosse	Sprossen
Spruch	Sprüche
Sprung	Sprünge
Spuk	Spuke
Spurt	Spurts	Spurte
Sputnik	Sputniks
Spähtrupp	Spähtrupps
Staat	Staaten
Staatsanwalt	Staatsanwälte
Staatsapparat	Staatsapparate
Staatsbesuch	Staatsbesuche
Staatsbetrieb	Staatsbetriebe
Staatsbürger	Staatsbürger
Staatschef	Staatschefs
Staatsdiener	Staatsdiener
Staatsdienst	Staatsdienste
Staatsfeind	Staatsfeinde
Staatsgast	Staatsgäste
Staatshaushalt	Staatshaushalte
Staatsmann	Staatsmänner
Staatsmeister	Staatsmeister
Staatsminister	Staatsminister
Staatspreis	Staatspreise
Staatsrat	Staatsräte
Staatsschutz	—
Staatssekretär	Staatssekretäre
Staatssicherheitsdienst	Staatssicherheitsdienste
Staatsstreich	Staatsstreiche
Staatsvertrag	Staatsverträge
Stab	Stäbe
Stabhochsprung	Stabhochsprünge
Stabschef	Stabschefs
Stachel	Stacheln
Stacheldraht	Stacheldrähte
Stadtbezirk	Stadtbezirke
Stadtbus	Stadtbusse
Stadtchef	Stadtchefs
Stadtkern	Stadtkerne
Stadtpark	Stadtparks	Stadtparke	Stadtpärke
Stadtplan	Stadtpläne
Stadtplaner	Stadtplaner
Stadtrand	Stadtranden
Stadtrat	Stadträte
Stadtsenat	Stadtsenate
Stadtstaat	Stadtstaaten
Stadtteil	Stadtteile
Stadtteilpolitiker	Stadtteilpolitiker
Stadtverkehr	Stadtverkehre
Stadtwald	Stadtwälder
Stahl	Stähle	Stahle
Stahlkonzern	Stahlkonzerne
Stalinismus	—
Stall	Ställe
Stamm	Stämme
Stammbaum	Stammbäume
Stammgast	Stammgäste
Stammkunde	Stammkunden
Stammplatz	Stammplätze
Stammsitz	Stammsitze
Stammspieler	Stammspieler
Stammtisch	Stammtische
Stand	Stände
Standard	Standards
Standardwert	Standardwerte
Standort	Standorte
Standortfaktor	Standortfaktoren
Standortvorteil	Standortvorteile
Standplatz	Standplätze
Standpunkt	Standpunkte
Stapel	Stapel
Star	Stare
Stargast	Stargäste
Start	Starts
Starter	Starter
Startplatz	Startplätze
Startschuss	Startschüsse
Statist	Statisten
Statistiker	Statistiker
Statthalter	Statthalter
Status	Status
Stau	Staus	Staue
Staub	Staube
Staubsauger	Staubsauger
Staudamm	Staudämme
Stauraum	Stauräume
Stausee	Stauseen
Stecher	Stecher
Steckbrief	Steckbriefe
Stecker	Stecker
Steg	Stege
Stehplatz	Stehplätze
Steig	Steige
Steiger	Steiger
Steilhang	Steilhänge
Stein	Steine
Steinbock	Steinböcke
Steinbruch	Steinbrüche
Steinmetz	Steinmetze	Steinmetzen
Steinwurf	Steinwürfe
Steirer	Steirer
Stellenabbau	—
Stellenwert	Stellenwerte
Stellplatz	Stellplätze
Stellvertreter	Stellvertreter
Stempel	Stempel
Stengel	Stengels	Stengel
Step	Steps
Sterling	Sterlinge
Sternenhimmel	Sternenhimmel
Sternsinger	Sternsinger
Steuerausfall	Steuerausfälle
Steuerberater	Steuerberater
Steuerfahnder	Steuerfahnder
Steuermann	Steuermänner
Steuerplan	Steuerpläne
Steuersatz	Steuersätze
Steuervorteil	Steuervorteile
Steuerzahler	Steuerzahler
Steven	Steven
Stich	Stiche
Stichtag	Stichtage
Stickstoff	Stickstoffe
Stiefel	Stiefel
Stiefvater	Stiefväter
Stiel	Stiele
Stier	Stiere
Stift	Stifte
Stiftungsrat	Stiftungsräte
Stil	Stile
Stillstand	Stillstände
Stimmenanteil	Stimmenanteile
Stimmzettel	Stimmzettel
Stipendiat	Stipendiaten
Stock	Stöcke
Stoff	Stoffe
Stoffwechsel	Stoffwechsel
Stollen	Stollen
Stolperstein	Stolpersteine
Stolz	—
Stopp	Stopps
Storch	Störche
Strafantrag	Strafanträge
Strafbefehl	Strafbefehle
Strafgerichtshof	Strafgerichtshöfe
Strafprozess	Strafprozesse
Strafraum	Strafräume
Strafsenat	Strafsenate
Straftatbestand	Straftatbestände
Strafverteidiger	Strafverteidiger
Strafvollzug	Strafvollzüge
Strafzettel	Strafzettel
Strafzoll	Strafzölle
Strahl	Strahlen
Strahlenschutz	—
Strand	Stranden
Strang	Stränge
Stratege	Strategen
Strauch	Sträucher
Strauß	Sträuße
Straßenrand	Straßenranden
Streckenabschnitt	Streckenabschnitte
Streetball	—
Streetworker	Streetworker
Streich	Streiche
Streichelzoo	Streichelzoos
Streicher	Streicher
Streif	Streife	Streifen
Streifen	Streifen
Streifenwagen	Streifenwagen
Streifzug	Streifzüge
Streik	Streiks
Streit	Streite
Streiter	Streiter
Streitfall	Streitfälle
Streithahn	Streithähne
Streitpunkt	Streitpunkte
Stress	Stresse
Streubesitz	Streubesitze
Strich	Striche
Strick	Stricke
Stricker	Stricker
Strip	Strips
Striptease	-
Strohhalm	Strohhalme
Strohmann	Strohmänner	Strohleute
Strom	Ströme
Stromausfall	Stromausfälle
Stromerzeuger	Stromerzeuger
Stromkonzern	Stromkonzerne
Strommarkt	Strommärkte
Strommast	Strommaste	Strommasten
Strompreis	Strompreise
Stromverbrauch	Stromverbräuche
Stromversorger	Stromversorger
Strudel	Strudel
Strukturwandel	Strukturwandel
Strumpf	Strümpfe
Sträfling	Sträflinge
Stuck	—
Student	Studenten
Studentenprotest	Studentenproteste
Studiengang	Studiengänge
Studienplatz	Studienplätze
Stuhl	Stühle
Stummfilm	Stummfilme
Stumpf	Stümpfe
Stundenkilometer	Stundenkilometer
Stundenlohn	Stundenlöhne
Stundenplan	Stundenpläne
Stunt	Stunts
Sturz	Stürze	Sturze
Ständer	Ständer
Stützpunkt	Stützpunkte
Subkontinent	Subkontinente
Subunternehmer	Subunternehmer
Subventionsabbau	—
Sucher	Sucher
Suchtrupp	Suchtrupps
Sud	Sude
Suff	—
Suizid	Suizide
Sultan	Sultane
Summer	Summer
Sumpf	Sümpfe
Sunnit	Sunniten
Supercup	Supercups
Superheld	Superhelden
Superlativ	Superlative
Supermarkt	Supermärkte
Superstar	Superstars
Support	Supporte
Surfer	Surfer
Surrealismus	—
Surrealist	Surrealisten
Swimmingpool	Swimmingpools
Sympathisant	Sympathisanten
Symphoniker	Symphoniker
Synergieeffekt	Synergieeffekte
Synthesizer	Synthesizer
Syrer	Syrer
Systemwechsel	Systemwechsel
Szenenwechsel	Szenenwechsel
Säbel	Säbel
Säufer	Säufer
Söldner	Söldner
Süd	Süde
Südosten	—
Tabak	Tabake
Tabakkonzern	Tabakkonzerne
Tabellenplatz	Tabellenplätze
Tabubruch	Tabubrüche
Tadel	Tadel
Tag	Tage
Tagebau	Tagebaue
Tagesablauf	Tagesabläufe
Tagesausflug	Tagesausflüge
Tagesordnungspunkt	Tagesordnungspunkte
Tagessatz	Tagessätze
Tagessieg	Tagessiege
Tagessieger	Tagessieger
Tagesverlauf	Tagesverläufe
Tagungsort	Tagungsorte
Taifun	Taifune
Take	Takes
Takt	Takte
Taktiker	Taktiker
Taler	Taler
Talisman	Talismane
Tamile	Tamilen
Tang	Tange
Tango	Tangos
Tank	Tanks	Tanke
Tanker	Tanker
Tankwagen	Tankwagen	Tankwägen
Tankwart	Tankwarte
Tannenbaum	Tannenbäume
Tanz	Tänze
Tarif	Tarife
Tarifabschluss	Tarifabschlüsse
Tarifkonflikt	Tarifkonflikte
Tariflohn	Tariflöhne
Tarifpartner	Tarifpartner
Tarifstreit	Tarifstreite
Tarifvertrag	Tarifverträge
Taschendieb	Taschendiebe
Taschenrechner	Taschenrechner
Task	Tasks
Tatbestand	Tatbestände
Tatendrang	—
Tathergang	Tathergänge
Tatort	Tatorte
Tatverdacht	—
Tau	Taus
Taucher	Taucher
Tauer	Tauer
Taugenichts	Taugenichtse
Taumel	—
Taunus	—
Tausch	Tausche	Täusche
Tausender	Tausender
Taxi	Taxis
Taxifahrer	Taxifahrer
Taxler	Taxler
Teamchef	Teamchefs
Teamgeist	—
Teamkollege	Teamkollegen
Teammanager	Teammanager
Techniker	Techniker
Techno	—
Technokrat	Technokraten
Technologiekonzern	Technologiekonzerne
Technologiepark	Technologieparks
Technologiewert	Technologiewerte
Teddy	Teddys
Teddybär	Teddybären
Tee	Teen
Teenager	Teenager
Teenie	Teenies
Teich	Teiche
Teig	Teige
Teil	Teile
Teilbereich	Teilbereiche
Teilerfolg	Teilerfolge
Teilhaber	Teilhaber
Teilnehmer	Teilnehmer
Teint	Teints
Telefonanruf	Telefonanrufe
Telefonanschluss	Telefonanschlüsse
Telekommunikationsmarkt	Telekommunikationsmärkte
Teller	Teller
Tellerrand	Tellerränder
Tempel	Tempel
Tennisplatz	Tennisplätze
Tennisprofi	Tennisprofis
Tennisspieler	Tennisspieler
Teppich	Teppiche
Teppichboden	Teppichböden
Term	Terme
Termin	Termine
Terminal	Terminals
Terminator	Terminatoren
Terminkalender	Terminkalender
Terminplan	Terminpläne
Terminus	Termini
Terrier	Terrier
Terror	—
Terrorakt	Terrorakte
Terroranschlag	Terroranschläge
Terrorismus	Terrorismen
Terrorist	Terroristen
Test	Tests
Tester	Tester
Testlauf	Testläufe
Teufel	Teufel
Teufelskreis	Teufelskreise
Texaner	Texaner
Text	Texte
Texter	Texter
Theaterabend	Theaterabende
Theatermacher	Theatermacher
Themenabend	Themenabende
Themenbereich	Themenbereiche
Themenpark	Themenparks
Themenschwerpunkt	Themenschwerpunkte
Theologe	Theologen
Theoretiker	Theoretiker
Therapeut	Therapeuten
Thermometer	Thermometer
Thon	Thons
Thriller	Thriller
Thron	Throne
Thronfolger	Thronfolger
Thurgau	—
Tibeter	Tibeter
Tick	Ticks
Ticker	Ticker
Tiefbau	Tiefbauten
Tiefflug	Tiefflüge
Tiefgang	Tiefgänge
Tiefpunkt	Tiefpunkte
Tiefschlaf	—
Tiefschlag	Tiefschläge
Tiefstand	Tiefstände
Tierarzt	Tierärzte
Tierfreund	Tierfreunde
Tiergarten	Tiergärten
Tierpark	Tierparks	Tierparke	Tierpärke
Tierschutz	—
Tierschutzverein	Tierschutzvereine
Tierversuch	Tierversuche
Tiger	Tiger
Tip	Tips
Tipp	Tipps
Tisch	Tische
Tischler	Tischler
Titel	Titel
Titelfavorit	Titelfavoriten
Titelgewinn	Titelgewinne
Titelheld	Titelhelden
Titelkampf	Titelkämpfe
Titelverteidiger	Titelverteidiger
Toast	Toaste
Toaster	Toaster
Tobel	Tobel
Tod	Tode
Todesfall	Todesfälle
Todesschuss	Todesschüsse
Todestag	Todestage
Ton	Töne
Tonfall	Tonfälle
Tony	Tonys
Topf	Töpfe
Topfavorit	Topfavoriten
Topmanager	Topmanager
Topstar	Topstars
Torerfolg	Torerfolge
Tormann	Tormänner	Torleute
Tornado	Tornados
Torpedo	Torpedos
Torschuss	Torschüsse
Torso	Torsos
Torwart	Torwarte
Tory	Tories	Torys
Totalitarismus	Totalitarismen
Totalschaden	Totalschäden
Totenkopf	Totenköpfe
Totentanz	Totentänze
Toto	Totos
Totschlag	—
Touch	Touchs
Tourengeher	Tourengeher
Tourenwagen	Tourenwagen	Tourenwägen
Tourismus	—
Tourist	Touristen
Touristiker	Touristiker
Trab	—
Traber	Traber
Track	Tracks
Traditionalist	Traditionalisten
Traditionsklub	Traditionsklubs
Traditionsverein	Traditionsvereine
Train	Trains
Trainer	Trainer
Trainerwechsel	Trainerwechsel
Trainingsanzug	Trainingsanzüge
Trainingsplatz	Trainingsplätze
Trakt	Trakte
Traktat	Traktate
Traktor	Traktoren
Tramp	Tramps
Tran	Trane
Trank	Tränke
Transfer	Transfers
Transistor	Transistoren
Transitverkehr	Transitverkehr
Transport	Transporte
Transporter	Transporter
Transportweg	Transportwege
Transvestit	Transvestiten
Trapp	Trappe
Tratsch	—
Trauergast	Trauergäste
Trauergottesdienst	Trauergottesdienste
Traum	Träume
Traumberuf	Traumberufe
Trauner	Trauner
Trauzeuge	Trauzeugen
Treffer	Treffer
Treffpunkt	Treffpunkte
Treiber	Treiber
Treibhauseffekt	Treibhauseffekte
Treibstoff	Treibstoffe
Treibstoffpreis	Treibstoffpreise
Trend	Trends
Trendsetter	Trendsetter
Tresen	Tresen
Tresor	Tresore
Tresorraum	Tresorräume
Triathlet	Triathleten
Triathlon	Triathlons
Tribut	Tribute
Trichter	Trichter
Trick	Tricks
Trickdieb	Trickdiebe
Trickfilm	Trickfilme
Trieb	Triebe
Triebwagen	Triebwagen	Triebwägen
Trinker	Trinker
Trip	Trips
Tritt	Tritte
Trittbrettfahrer	Trittbrettfahrer
Triumph	Triumphe
Troll	Trolle
Trommler	Trommler
Trompeter	Trompeter
Tropfen	Tropfen
Tropus	Tropen
Trost	Troste
Trottel	Trottel
Trotz	—
Trubel	—
Truck	Trucks
Trugschluss	Trugschlüsse
Trumpf	Trümpfe
Trunk	Trünke
Trupp	Trupps
Truppenabzug	Truppenabzüge
Trust	Trusts	Truste
Truthahn	Truthähne
Träger	Träger
Träumer	Träumer
Tscheche	Tschechen
Tsunami	Tsunamis	Tsunami
Tummelplatz	Tummelplätze
Tumor	Tumoren	Tumore
Tumult	Tumulte
Tunesier	Tunesier
Tunnel	Tunnel
Tunnelbau	Tunnelbauten
Turban	Turbane
Turbo	Turbos
Turm	Türme
Turner	Turner
Turniersieg	Turniersiege
Turniersieger	Turniersieger
Turnsaal	Turnsäle
Turnschuh	Turnschuhe
Turnus	Turnusse
Turnverein	Turnvereine
Typ	Typen
Tyrann	Tyrannen
Tänzer	Tänzer
Täter	Täter
Täufer	Täufer
Türke	Türken
Türsteher	Türsteher
Ukrainer	Ukrainer
Ultra	Ultras
Ultraschall	—
Umbau	Umbaus
Umbruch	Umbrüche
Umfang	Umfänge
Umfragewert	Umfragewerte
Umgang	Umgänge
Umhang	Umhänge
Umkleideraum	Umkleideräume
Umkreis	Umkreise
Umlauf	Umläufe
Umriss	Umrisse
Umsatz	Umsätze
Umsatzanstieg	Umsatzanstiege
Umsatzzuwachs	Umsatzzuwächse
Umschlag	Umschläge
Umschlagplatz	Umschlagplätze
Umschwung	Umschwünge
Umstand	Umstanden
Umsturz	Umstürze
Umtausch	Umtausche	Umtäusche
Umtrieb	Umtriebe
Umweg	Umwege
Umweltausschuss	Umweltausschüsse
Umweltminister	Umweltminister
Umweltschaden	Umweltschäden
Umweltschutz	—
Umweltsenator	Umweltsenatoren
Umweltverband	Umweltverbände
Umzug	Umzüge
Unbill	—
Unfall	Unfälle
Unfallhergang	Unfallhergänge
Unfallort	Unfallorte
Unfalltod	Unfalltode
Unfallverursacher	Unfallverursacher
Unfug	—
Ungar	Ungarn
Ungehorsam	—
Unionist	Unionisten
Unionspolitiker	Unionspolitiker
Unkenruf	Unkenrufe
Unkostenbeitrag	Unkostenbeiträge
Unmut	—
Unrat	—
Unsinn	—
Unter	Unter
Unterarm	Unterarme
Unterausschuss	Unterausschüsse
Unterbau	Unterbauten
Unterbezirk	Unterbezirke
Untergang	Untergänge
Untergrund	Untergründe
Unterhalt	—
Unterhaltungswert	Unterhaltungswerte
Unterhändler	Unterhändler
Unterleib	Unterleiber
Untermieter	Untermieter
Unternehmensberater	Unternehmensberater
Unternehmensbereich	Unternehmensbereiche
Unternehmensgewinn	Unternehmensgewinne
Unternehmenssprecher	Unternehmenssprecher
Unternehmer	Unternehmer
Unternehmerverband	Unternehmerverbände
Unteroffizier	Unteroffiziere
Unterricht	Unterrichte
Unterrichtsausfall	Unterrichtsausfälle
Unterrichtsminister	Unterrichtsminister
Untersatz	Untersätze
Unterschenkel	Unterschenkel
Unterschied	Unterschiede
Unterschlupf	Unterschlüpfe
Untersuchungsausschuss	Untersuchungsausschüsse
Untersuchungsbericht	Untersuchungsberichte
Untersuchungsrichter	Untersuchungsrichter
Untertan	Untertanen
Untertitel	Untertitel
Unterton	Untertöne
Unterzeichner	Unterzeichner
Unwille	—
Ural	—
Ureinwohner	Ureinwohner
Urenkel	Urenkel
Urheber	Urheber
Urin	Urine
Urknall	Urknalle
Urlaub	Urlaube
Urlauber	Urlauber
Urlaubsort	Urlaubsorte
Urlaubstag	Urlaubstage
Urnengang	Urnengänge
Ursprung	Ursprünge
Urteilsspruch	Urteilssprüche
Urwald	Urwälder
User	User
Vagabund	Vagabunden
Vampir	Vampire
Vandale	Vandalen
Vandalismus	—
Vater	Väter
Vatikan	—
Vegetarier	Vegetarier
Velofahrer	Velofahrer
Velvet	Velvets
Ventilator	Ventilatoren
Veranstalter	Veranstalter
Veranstaltungskalender	Veranstaltungskalender
Veranstaltungsort	Veranstaltungsorte
Verband	Verbände
Verbandschef	Verbandschefs
Verbesserungsvorschlag	Verbesserungsvorschläge
Verbleib	—
Verbrauch	Verbräuche
Verbraucher	Verbraucher
Verbraucherpreis	Verbraucherpreise
Verbraucherschutz	—
Verbraucherverband	Verbraucherverbände
Verbrecher	Verbrecher
Verbund	Verbunde	Verbünde
Verdacht	Verdachte
Verdachtsfall	Verdachtsfälle
Verdienst	Verdienste
Verdienstorden	Verdienstorden
Verdruss	Verdrusse
Verehrer	Verehrer
Verein	Vereine
Vereinschef	Vereinschefs
Vereinsvorstand	Vereinsvorstände
Verfall	Verfälle
Verfasser	Verfasser
Verfassungsgerichtshof	Verfassungsgerichtshöfe
Verfassungsrechtler	Verfassungsrechtler
Verfassungsrichter	Verfassungsrichter
Verfassungsschutz	—
Verfechter	Verfechter
Verfolger	Verfolger
Vergewaltiger	Vergewaltiger
Vergleich	Vergleiche
Vergleichszeitraum	Vergleichszeiträume
Vergnügungspark	Vergnügungsparks
Verhaltenskodex	Verhaltenskodexe
Verhandlungspartner	Verhandlungspartner
Verhandlungstag	Verhandlungstage
Verhandlungstisch	Verhandlungstische
Verkauf	Verkäufe
Verkaufsleiter	Verkaufsleiter
Verkaufspreis	Verkaufspreise
Verkaufsraum	Verkaufsräume
Verkaufsstand	Verkaufsstände
Verkehr	Verkehre
Verkehrsausschuss	Verkehrsausschüsse
Verkehrsbetrieb	Verkehrsbetriebe
Verkehrsexperte	Verkehrsexperten
Verkehrsminister	Verkehrsminister
Verkehrsplaner	Verkehrsplaner
Verkehrssenator	Verkehrssenatoren
Verkehrssprecher	Verkehrssprecher
Verkehrsstrom	Verkehrsströme
Verkehrsteilnehmer	Verkehrsteilnehmer
Verkehrsunfall	Verkehrsunfälle
Verkehrsverbund	Verkehrsverbunde	Verkehrsverbünde
Verkehrsverein	Verkehrsvereine
Verkehrsweg	Verkehrswege
Verkehrswert	Verkehrswerte
Verkäufer	Verkäufer
Verlag	Verlage
Verlass	—
Verlauf	Verläufe
Verleger	Verleger
Verleih	Verleihe
Verleiher	Verleiher
Verlierer	Verlierer
Verlust	Verluste
Verlustvortrag	Verlustvorträge
Vermarkter	Vermarkter
Vermerk	Vermerke
Vermieter	Vermieter
Vermittler	Vermittler
Vermittlungsausschuss	Vermittlungsausschüsse
Vernichtungskrieg	Vernichtungskriege
Verrat	—
Vers	Verse
Versager	Versager
Versand	Versanden
Versandhandel	—
Verschluss	Verschlüsse
Verschwörer	Verschwörer
Versicherer	Versicherer
Versicherungskonzern	Versicherungskonzerne
Versicherungsschutz	Versicherungsschutze
Versorger	Versorger
Verstand	Verstanden
Verstoß	Verstöße
Versuch	Versuche
Verteidiger	Verteidiger
Verteidigungsausschuss	Verteidigungsausschüsse
Verteidigungsminister	Verteidigungsminister
Verteilungskampf	Verteilungskämpfe
Vertrag	Verträge
Vertragsabschluss	Vertragsabschlüsse
Vertragsentwurf	Vertragsentwürfe
Vertragspartner	Vertragspartner
Vertrauensverlust	Vertrauensverluste
Vertreter	Vertreter
Vertrieb	Vertriebe
Vertriebsweg	Vertriebswege
Verursacher	Verursacher
Verwalter	Verwalter
Verwaltungsaufwand	Verwaltungsaufwände
Verwaltungschef	Verwaltungschefs
Verwaltungsdirektor	Verwaltungsdirektoren
Verwaltungsgerichtshof	Verwaltungsgerichtshöfe
Verwaltungsrat	Verwaltungsräte
Verweigerer	Verweigerer
Verweis	Verweise
Verwendungszweck	Verwendungszwecke
Verzehr	—
Verzicht	Verzichte
Verzug	Verzüge
Veteran	Veteranen
Vetter	Vettern
Videoclip	Videoclips
Videofilm	Videofilme
Vierbeiner	Vierbeiner
Vierer	Vierer
Vierkampf	Vierkämpfe
Vierziger	Vierziger
Vierzylinder	Vierzylinder
Vietnamese	Vietnamesen
Vietnamkrieg	—
Virtuose	Virtuosen
Virus	Viren
Vize	Vizes
Vizechef	Vizechefs
Vizekanzler	Vizekanzler
Vizemeister	Vizemeister
Vizepremier	Vizepremiers
Vizepräsident	Vizepräsidenten
Vizeweltmeister	Vizeweltmeister
Vogel	Vögel
Vogelschutz	—
Vogler	Vogler
Vogt	Vögte
Vokal	Vokale
Volksanwalt	Volksanwälte
Volksaufstand	Volksaufstände
Volksentscheid	Volksentscheide
Volksheld	Volkshelden
Volkskongress	Volkskongresse
Volksmund	—
Volkspark	Volksparks
Volkssport	—
Volkstanz	Volkstänze
Volksvertreter	Volksvertreter
Volkswirt	Volkswirte
Vollbart	Vollbärte
Volley	Volleys
Volleyball	Volleybälle
Volleyballer	Volleyballer
Vollidiot	Vollidioten
Vollmond	Vollmonde
Vollstrecker	Vollstrecker
Volltreffer	Volltreffer
Voodoo	—
Vorabend	Vorabende
Voranschlag	Voranschläge
Vorbehalt	Vorbehalte
Vorbote	Vorboten
Vordenker	Vordenker
Vordergrund	Vordergründe
Vordermann	Vordermänner	Vorderleute
Vorfahr	Vorfahren
Vorfahre	Vorfahren
Vorfall	Vorfälle
Vorgang	Vorgänge
Vorgarten	Vorgärten
Vorgeschmack	—
Vorgesetzte	Vorgesetzten
Vorgriff	Vorgriffe
Vorgänger	Vorgänger
Vorhang	Vorhänge
Vorjahresmonat	Vorjahresmonate
Vorjahressieger	Vorjahressieger
Vorjahreswert	Vorjahreswerte
Vorjahreszeitraum	Vorjahreszeiträume
Vorlauf	Vorläufe
Vormarsch	Vormärsche
Vormittag	Vormittage
Vormonat	Vormonate
Vormund	Vormunde
Vorname	Vornamen
Vorort	Vororte
Vorplatz	Vorplätze
Vorrang	—
Vorrat	Vorräte
Vorraum	Vorräume
Vorreiter	Vorreiter
Vorruhestand	Vorruhestände
Vorsatz	Vorsätze
Vorschein	—
Vorschlag	Vorschläge
Vorschub	Vorschübe
Vorschuss	Vorschüsse
Vorsitz	Vorsitze
Vorspann	Vorspanne
Vorsprung	Vorsprünge
Vorstand	Vorstände
Vorstandschef	Vorstandschefs
Vorstandskollege	Vorstandskollegen
Vorstandssprecher	Vorstandssprecher
Vorsteher	Vorsteher
Vorsteuergewinn	Vorsteuergewinne
Vortag	Vortage
Vorteil	Vorteile
Vortrag	Vorträge
Vortritt	Vortritte
Vorverkauf	Vorverkäufe
Vorwand	Vorwanden
Vorwurf	Vorwürfe
Voyeurismus	—
Vulkan	Vulkane
Vulkanausbruch	Vulkanausbrüche
Völkermord	Völkermorde
Wachdienst	Wachdienste
Wachmann	Wachleute
Wachposten	Wachposten
Wachstumsmarkt	Wachstumsmärkte
Wachtmeister	Wachtmeister
Waffenbesitz	Waffenbesitze
Waffenhandel	—
Waffenhändler	Waffenhändler
Waffenstillstand	Waffenstillstanden
Wagen	Wagen
Waggon	Waggons
Wahlabend	Wahlabende
Wahlausgang	Wahlausgänge
Wahlbeobachter	Wahlbeobachter
Wahlbetrug	Wahlbetrüge
Wahlbezirk	Wahlbezirke
Wahlerfolg	Wahlerfolge
Wahlgang	Wahlgänge
Wahlhelfer	Wahlhelfer
Wahlkampf	Wahlkämpfe
Wahlkreis	Wahlkreise
Wahlsieg	Wahlsiege
Wahlsieger	Wahlsieger
Wahlsonntag	Wahlsonntage
Wahltag	Wahltage
Wahlvorschlag	Wahlvorschläge
Wahlzettel	Wahlzettel
Wahn	Wahne
Wahnsinn	—
Wahrheitsgehalt	Wahrheitsgehalte
Wal	Wale
Wald	Wälder
Waldbrand	Waldbrände
Waldrand	Waldränder
Waldsee	Waldseen
Waldweg	Waldwege
Walfang	—
Walkman	Walkmans	Walkmen
Wallach	Wallache
Wallfahrtsort	Wallfahrtsorte
Walter	Walters
Walzer	Walzer
Wandel	Wandel
Wanderer	Wanderer
Wanderpokal	Wanderpokale
Wandertag	Wandertage
Wanderweg	Wanderwege
Wandler	Wandler
Wank	Wanks
Warentest	Warentests
Warenverkehr	Warenverkehre
Warner	Warner
Warnschuss	Warnschüsse
Warnstreik	Warnstreiks	Warnstreike
Waschbär	Waschbären
Wasserball	Wasserbälle
Wasserdampf	Wasserdämpfe
Wasserfall	Wasserfälle
Wasserhahn	Wasserhähne
Wassermann	Wassermänner
Wasserstand	Wasserstände
Wasserstoff	—
Wasserturm	Wassertürme
Wasserverbrauch	Wasserverbräuche
Wasserwerfer	Wasserwerfer
Weber	Weber
Wechsel	Wechsel
Wechselkurs	Wechselkurse
Wechsler	Wechsler
Wecker	Wecker
Wedel	Wedel
Weg	Wege
Wegbereiter	Wegbereiter
Wegfall	—
Weggang	Weggänge
Wegweiser	Wegweiser
Wegzug	Wegzüge
Wehrdienst	Wehrdienste
Wehrmann	Wehrmänner	Wehrmannen	Wehrleute
Weibel	Weibel
Weidmann	Weidmänner
Weihbischof	Weihbischöfe
Weiher	Weiher
Weihnachtsbaum	Weihnachtsbäume
Weihnachtsfeiertag	Weihnachtsfeiertage
Weihnachtsmann	Weihnachtsmänner
Weihnachtsmarkt	Weihnachtsmärkte
Weihnachtstag	Weihnachtstage
Weihrauch	Weihrauche
Weiler	Weiler
Wein	Weine
Weinbau	—
Weinbauer	Weinbauern
Weinberg	Weinberge
Weingarten	Weingärten
Weinkeller	Weinkeller
Weinzierl	Weinzierle
Weitblick	—
Weiterbau	—
Weitsprung	Weitsprünge
Weißwein	Weißweine
Weller	Weller
Welpe	Welpen
Weltcup	Weltcups
Weltcupsieg	Weltcupsiege
Weltcupsieger	Weltcupsieger
Welterfolg	Welterfolge
Welthandel	—
Weltkongress	Weltkongresse
Weltkonzern	Weltkonzerne
Weltkrieg	Weltkriege
Weltmarkt	Weltmärkte
Weltmarktpreis	Weltmarktpreise
Weltmeister	Weltmeister
Weltmeistertitel	Weltmeistertitel
Weltraum	—
Weltrekord	Weltrekorde
Weltrekordler	Weltrekordler
Weltruhm	—
Weltsicherheitsrat	—
Weltstar	Weltstars
Weltuntergang	Weltuntergänge
Weltverband	Weltverbände
Weltwirtschaftsgipfel	Weltwirtschaftsgipfel
Wendepunkt	Wendepunkte
Wender	Wender
Werbefilm	Werbefilme
Werber	Werber
Werbeslogan	Werbeslogans
Werbespot	Werbespots
Werdegang	Werdegänge
Werder	Werder
Werfer	Werfer
Werkstoff	Werkstoffe
Werktag	Werktage
Werkvertrag	Werkverträge
Wermutstropfen	Wermutstropfen
Wert	Werte
Wertgegenstand	Wertgegenstände
West	Weste
Westen	—
Western	Western
Westerwald	—
Westfale	Westfalen
Westler	Westler
Westteil	Westteile
Wettbewerb	Wettbewerbe
Wettbewerber	Wettbewerber
Wettbewerbsdruck	Wettbewerbsdrücke
Wettbewerbsnachteil	Wettbewerbsnachteile
Wettbewerbsvorteil	Wettbewerbsvorteile
Wetterbericht	Wetterberichte
Wetterdienst	Wetterdienste
Wetterfrosch	Wetterfrösche
Wettergott	Wettergötter
Wettkampf	Wettkämpfe
Wettkampftag	Wettkampftage
Wettlauf	Wettläufe
Wettstreit	Wettstreite
Whiskey	Whiskeys
Whisky	Whiskys
Widder	Widder
Widerpart	Widerparte
Widerruf	Widerrufe
Widersacher	Widersacher
Widerspruch	Widersprüche
Widerstand	Widerstanden
Wiederaufbau	Wiederaufbaus
Wiener	Wiener
Wienerwald	—
Wikinger	Wikinger
Wildbach	Wildbäche
Wilderer	Wilderer
Wildpark	Wildparks	Wildparke
Wildwuchs	Wildwüchse
Wille	Willen
Willen	Willen
Wind	Winde
Windpark	Windparks	Windparke	Windpärke
Windschatten	Windschatten
Wink	Winke
Winkel	Winkel
Winter	Winter
Winterdienst	Winterdienste
Wintereinbruch	Wintereinbrüche
Wintergarten	Wintergärten
Wintermonat	Wintermonate
Winterreifen	Winterreifen
Winterschlaf	—
Wintersport	—
Wintersportler	Wintersportler
Wintersportort	Wintersportorte
Winzer	Winzer
Winzling	Winzlinge
Wirbel	Wirbel
Wirbelsturm	Wirbelstürme
Wirkstoff	Wirkstoffe
Wirkungsgrad	Wirkungsgrade
Wirrwarr	Wirrwarre	Wirrwarrs
Wirt	Wirte
Wirtschaftsaufschwung	Wirtschaftsaufschwünge
Wirtschaftsausschuss	Wirtschaftsausschüsse
Wirtschaftsexperte	Wirtschaftsexperten
Wirtschaftsfaktor	Wirtschaftsfaktoren
Wirtschaftsforscher	Wirtschaftsforscher
Wirtschaftsminister	Wirtschaftsminister
Wirtschaftsplan	Wirtschaftspläne
Wirtschaftsprofessor	Wirtschaftsprofessoren
Wirtschaftsraum	Wirtschaftsräume
Wirtschaftssenator	Wirtschaftssenatoren
Wirtschaftsstandort	Wirtschaftsstandorte
Wirtschaftsverband	Wirtschaftsverbände
Wirtschaftsvertreter	Wirtschaftsvertreter
Wirtschaftswissenschaftler	Wirtschaftswissenschaftler
Wirtschaftszweig	Wirtschaftszweige
Wischer	Wischer
Wissenschafter	Wissenschafter
Wissenschaftler	Wissenschaftler
Wissenschaftsminister	Wissenschaftsminister
Wissensstand	Wissensstände
Witwer	Witwer
Witz	Witze
Wochenbeginn	Wochenbeginne
Wochenmarkt	Wochenmärkte
Wochentag	Wochentage
Wodka	Wodkas
Wohlfahrtsstaat	Wohlfahrtsstaaten
Wohlfahrtsverband	Wohlfahrtsverbände
Wohlstand	Wohlstanden
Wohnbau	Wohnbauten
Wohnbereich	Wohnbereiche
Wohnblock	Wohnblöcke	Wohnblocks
Wohnort	Wohnorte
Wohnraum	Wohnräume
Wohnsitz	Wohnsitze
Wohnungsbau	—
Wohnungsbrand	Wohnungsbrände
Wohnungsmarkt	Wohnungsmärkte
Wohnwagen	Wohnwagen
Wolkenkratzer	Wolkenkratzer
Wood	Woods
Workshop	Workshops
Wortlaut	—
Wortschatz	Wortschätze
Wortsinn	—
Wotan	—
Wunsch	Wünsche
Wunschkandidat	Wunschkandidaten
Wunschtraum	Wunschträume
Wunschzettel	Wunschzettel
Wurf	Würfe
Wurm	Würmer
Wust	—
Wähler	Wähler
Wäschekorb	Wäschekörbe
Würfel	Würfel
Yankee	Yankees
Yen	Yens
Yoga	Yogas
Youngster	Youngster	Youngsters
Yuan	Yuan	Yuans
Yuppie	Yuppies
Zahler	Zahler
Zahlungsverkehr	—
Zahn	Zähne
Zahnarzt	Zahnärzte
Zahnersatz	—
Zahnstocher	Zahnstocher
Zander	Zander
Zankapfel	Zankäpfel
Zapf	Zäpfe
Zapfenstreich	Zapfenstreiche
Zar	Zaren
Zauber	Zauber
Zauberer	Zauberer
Zauberlehrling	Zauberlehrlinge
Zauberstab	Zauberstäbe
Zaum	Zäume
Zaun	Zäune
Zaungast	Zaungäste
Zebrastreifen	Zebrastreifen
Zeh	Zehen
Zehnkampf	Zehnkämpfe
Zeichentrickfilm	Zeichentrickfilme
Zeichner	Zeichner
Zeigefinger	Zeigefinger
Zeiger	Zeiger
Zeitaufwand	Zeitaufwände
Zeitdruck	—
Zeitgeist	—
Zeitgenosse	Zeitgenossen
Zeitplan	Zeitpläne
Zeitpunkt	Zeitpunkte
Zeitraffer	—
Zeitrahmen	Zeitrahmen
Zeitraum	Zeiträume
Zeitungsartikel	Zeitungsartikel
Zeitungsbericht	Zeitungsberichte
Zeitungsverleger	Zeitungsverleger
Zeitvertreib	Zeitvertreibe
Zeitzeuge	Zeitzeugen
Zeller	—
Zellkern	Zellkerne
Zelten	Zelten
Zement	Zementen
Zenit	—
Zensor	Zensoren
Zentimeter	Zentimeter
Zentner	Zentner
Zentralbankrat	Zentralbankräte
Zentralismus	—
Zentralrat	Zentralräte
Zentralverband	Zentralverbände
Zepter	Zepter
Zerfall	Zerfälle
Zerstörer	Zerstörer
Zeuge	Zeugen
Zeugenstand	Zeugenstanden
Ziegel	Ziegel
Ziegler	Zieglers	Ziegler
Ziehvater	Ziehväter
Zielort	Zielorte
Ziemer	Ziemer
Zigeuner	Zigeuner
Zimmermann	Zimmerleute
Zimmerservice	Zimmerservices
Zimt	Zimte
Zins	Zinsen	Zinse
Zinsertrag	Zinserträge
Zinssatz	Zinssätze
Zionismus	—
Zipfel	Zipfel
Zirkel	Zirkel
Zirkus	Zirkusse
Zitronensaft	Zitronensäfte
Zivildiener	Zivildiener
Zivildienst	Zivildienste
Zivilist	Zivilisten
Zivilprozess	Zivilprozesse
Zivilschutz	—
Zoff	—
Zoll	Zölle
Zoo	Zoos
Zoologe	Zoologen
Zopf	Zöpfe
Zorn	—
Zubau	Zubauten
Zuber	Zuber
Zubringer	Zubringer
Zucker	Zucker
Zufall	Zufälle
Zufluss	Zuflüsse
Zug	Züge
Zugang	Zugänge
Zugewinn	Zugewinne
Zugführer	Zugführer
Zugriff	Zugriffe
Zugverkehr	Zugverkehre
Zugvogel	Zugvögel
Zugzwang	—
Zukauf	Zukäufe
Zukunftsplan	Zukunftspläne
Zulauf	Zuläufe
Zulieferer	Zulieferer
Zuruf	Zurufe
Zusammenbruch	Zusammenbrüche
Zusammenhalt	—
Zusammenhang	Zusammenhänge
Zusammenprall	Zusammenpralle
Zusammenschluss	Zusammenschlüsse
Zusammenstoß	Zusammenstöße
Zusatz	Zusätze
Zusatzstoff	Zusatzstoffe
Zuschauer	Zuschauer
Zuschauerraum	Zuschauerräume
Zuschlag	Zuschläge
Zuschnitt	Zuschnitte
Zuschuss	Zuschüsse
Zuseher	Zuseher
Zuspruch	Zusprüche
Zustand	Zustanden
Zustrom	Zuströme
Zutritt	—
Zuwachs	Zuwächse
Zuwanderer	Zuwanderer
Zuzug	Zuzüge
Zwang	Zwänge
Zwangsarbeiter	Zwangsarbeiter
Zweck	Zwecke
Zweckverband	Zweckverbände
Zweier	Zweier
Zweifel	Zweifel
Zweifelsfall	Zweifelsfälle
Zweifler	Zweifler
Zweig	Zweige
Zweijahresvertrag	Zweijahresverträge
Zweikampf	Zweikämpfe
Zweiteiler	Zweiteiler
Zweitligist	Zweitligisten
Zweitschlüssel	Zweitschlüssel
Zweitwohnsitz	Zweitwohnsitze
Zwerg	Zwerge
Zwickel	Zwickel
Zwiespalt	Zwiespalte	Zwiespälte
Zwilling	Zwillinge
Zwillingsbruder	Zwillingsbrüder
Zwinger	Zwinger
Zwischenbericht	Zwischenberichte
Zwischenfall	Zwischenfälle
Zwischenraum	Zwischenräume
Zwischenruf	Zwischenrufe
Zwischenstand	Zwischenstände
Zwischenstopp	Zwischenstopps
Zwischenton	Zwischentöne
Zwist	Zwiste
Zyklus	Zyklen
Zylinder	Zylinder
Zyniker	Zyniker
Zynismus	Zynismen
Zähler	Zähler
Zügel	Zügel
Zünder	Zünder
Ärger	—
Überfall	Überfälle
Überfluss	—
Übergang	Übergänge
Überläufer	Überläufer
Überraschungsangriff	Überraschungsangriffe
Überrest	Überreste
Übersetzer	Übersetzer