Abberufung	Abberufungen
Abbildung	Abbildungen
Abdeckung	Abdeckungen
Abendakademie	Abendakademien
Abendkasse	Abendkassen
Abendstunde	Abendstunden
Abendzeitung	Abendzeitungen
Abfahrt	Abfahrten
Abfallentsorgung	—
Abfallwirtschaft	Abfallwirtschaften
Abfertigung	Abfertigungen
Abfindung	Abfindungen
Abfolge	Abfolgen
Abfrage	Abfragen
Abfuhr	Abfuhren
Abgabe	Abgaben
Abgeltung	Abgeltungen
Abgeordnetenhauswahl	Abgeordnetenhauswahlen
Abgeschiedenheit	—
Abgrenzung	Abgrenzungen
Abhaltung	Abhaltungen
Abhandlung	Abhandlungen
Abhilfe	Abhilfen
Abhängigkeit	Abhängigkeiten
Abkehr	—
Abkürzung	Abkürzungen
Ablage	Ablagen
Ablagerung	Ablagerungen
Ablehnung	Ablehnungen
Ableitung	Ableitungen
Ablenkung	Ablenkungen
Ablösung	Ablösungen
Abmachung	Abmachungen
Abmahnung	Abmahnungen
Abmessung	Abmessungen
Abnahme	Abnahmen
Abneigung	Abneigungen
Abordnung	Abordnungen
Abrechnung	Abrechnungen
Abreise	Abreisen
Abschaffung	Abschaffungen
Abschaltung	Abschaltungen
Abschiebehaft	—
Abschiebung	Abschiebungen
Abschlusskundgebung	Abschlusskundgebungen
Abschottung	Abschottungen
Abschreckung	Abschreckungen
Abschreibung	Abschreibungen
Absenkung	Absenkungen
Absetzung	Absetzungen
Absicherung	Absicherungen
Absicht	Absichten
Absolventin	Absolventinnen
Abspaltung	Abspaltungen
Absperrung	Absperrungen
Absprache	Absprachen
Abstammung	Abstammungen
Abstiegsrunde	Abstiegsrunden
Abstimmung	Abstimmungen
Abstinenz	—
Abstraktion	Abstraktionen
Abstufung	Abstufungen
Abtei	Abteien
Abteilung	Abteilungen
Abteilungsleiterin	Abteilungsleiterinnen
Abtreibung	Abtreibungen
Abtreibungspille	Abtreibungspillen
Abwahl	Abwahlen
Abwanderung	Abwanderungen
Abwechslung	Abwechslungen
Abwehr	—
Abweichung	Abweichungen
Abwertung	Abwertungen
Abwesenheit	Abwesenheiten
Abwicklung	Abwicklungen
Abzweigung	Abzweigungen
Achillessehne	Achillessehnen
Achse	Achsen
Achsel	Achseln
Achterbahn	Achterbahnen
Achtung	—
Action	—
Adaptierung	Adaptierungen
Adaption	Adaptionen
Ader	Adern
Administration	Administrationen
Admiralität	Admiralitäten
Adoption	Adoptionen
Adresse	Adressen
Adventszeit	Adventszeiten
Aerobic	—
Agenda	Agenden
Agentin	Agentinnen
Agentur	Agenturen
Aggression	Aggressionen
Agitation	Agitationen
Agonie	Agonien
Agrarpolitik	Agrarpolitiken
Agrarreform	Agrarreformen
Ahle	Ahlen
Ahnung	Ahnungen
Airline	Airlines
Akademie	Akademien
Akkreditierung	Akkreditierungen
Akquisition	Akquisitionen
Akribie	—
Akrobatik	—
Akte	Akten
Akteneinsicht	Akteneinsichten
Aktentasche	Aktentaschen
Aktie	Aktien
Aktiengesellschaft	Aktiengesellschaften
Aktienoption	Aktienoptionen
Aktion	Aktionen
Aktionsgemeinschaft	Aktionsgemeinschaften
Aktionswoche	Aktionswochen
Aktivierung	Aktivierungen
Aktivistin	Aktivistinnen
Aktivität	Aktivitäten
Aktualisierung	Aktualisierungen
Akupunktur	Akupunkturen
Akustik	Akustiken
Akzeptanz	—
Alarmanlage	Alarmanlagen
Alarmbereitschaft	Alarmbereitschaften
Alarmglocke	Alarmglocken
Alarmstufe	Alarmstufen
Alfa	Alfas
Alge	Algen
Alitalia	—
Allee	Alleen
Allegorie	Allegorien
Allergie	Allergien
Allgemeinbildung	—
Allgemeinheit	Allgemeinheiten
Allianz	Allianzen
Allmacht	—
Alm	Almen
Alpe	Alpen
Alpenrepublik	Alpenrepubliken
Alster	—
Altbauwohnung	Altbauwohnungen
Alte	Alten
Altenpflege	—
Altersgrenze	Altersgrenzen
Altersgruppe	Altersgruppen
Altersklasse	Altersklassen
Alterssicherung	Alterssicherungen
Altersstufe	Altersstufen
Altersteilzeit	Altersteilzeiten
Altersversorgung	Altersversorgungen
Altersvorsorge	Altersvorsorgen
Altlast	Altlasten
Altstadt	Altstädte
Amazone	Amazonen
Ambition	Ambitionen
Ambivalenz	Ambivalenzen
Ambulanz	Ambulanzen
Ameise	Ameisen
Amerikanerin	Amerikanerinnen
Amnesie	Amnesien
Amnestie	Amnestien
Ampel	Ampeln
Ampelanlage	Ampelanlagen
Ampelkoalition	Ampelkoalitionen
Amtsdauer	Amtsdauern
Amtsenthebung	Amtsenthebungen
Amtshandlung	Amtshandlungen
Amtsperiode	Amtsperioden
Amtssprache	Amtssprachen
Amtsstube	Amtsstuben
Amtszeit	Amtszeiten
Ana	Anas
Analogie	Analogien
Analyse	Analysen
Ananas	Ananas	Ananasse
Anarchie	Anarchien
Anatomie	Anatomien
Anbindung	Anbindungen
Andacht	Andachten
Andeutung	Andeutungen
Androhung	Androhungen
Aneignung	Aneignungen
Anekdote	Anekdoten
Anerkennung	Anerkennungen
Anfahrt	Anfahrten
Anfangsphase	Anfangsphasen
Anfangszeit	Anfangszeiten
Anfechtung	Anfechtungen
Anfeindung	Anfeindungen
Anforderung	Anforderungen
Anfrage	Anfragen
Angabe	Angaben
Angebotspalette	Angebotspaletten
Angeklagte	Angeklagten
Angel	Angeln
Angelegenheit	Angelegenheiten
Angestellte	Angestellten
Angewohnheit	Angewohnheiten
Angleichung	Angleichungen
Angst	Ängste
Anhebung	Anhebungen
Animation	Animationen
Anklage	Anklagen
Anklagebank	Anklagebänke
Anklageerhebung	Anklageerhebungen
Anklageschrift	Anklageschriften
Ankunft	Ankünfte
Ankurbelung	Ankurbelungen
Ankündigung	Ankündigungen
Anlage	Anlagen
Anlaufstelle	Anlaufstellen
Anlehnung	Anlehnungen
Anleihe	Anleihen
Anleitung	Anleitungen
Anmeldung	Anmeldungen
Anmerkung	Anmerkungen
Anmut	—
Annahme	Annahmen
Annehmlichkeit	Annehmlichkeiten
Annonce	Annoncen
Annäherung	Annäherungen
Anordnung	Anordnungen
Anpassung	Anpassungen
Anrechnung	Anrechnungen
Anrede	Anreden
Anregung	Anregungen
Anreicherung	Anreicherungen
Anreise	Anreisen
Anrufung	Anrufungen
Ansage	Ansagen
Ansammlung	Ansammlungen
Anschaffung	Anschaffungen
Anschauung	Anschauungen
Anschlussstelle	Anschlussstellen
Anschrift	Anschriften
Anschubfinanzierung	Anschubfinanzierungen
Anschuldigung	Anschuldigungen
Ansicht	Ansichten
Ansichtskarte	Ansichtskarten
Ansiedlung	Ansiedlungen
Anspannung	Anspannungen
Anspielung	Anspielungen
Ansprache	Ansprachen
Anstalt	Anstalten
Ansteckung	Ansteckungen
Anstellung	Anstellungen
Anstiftung	Anstiftungen
Anstrengung	Anstrengungen
Antarktis	—
Anteilnahme	—
Antenne	Antennen
Anthologie	Anthologien
Anthropologie	—
Antifa	Antifas
Antrittsrede	Antrittsreden
Antwort	Antworten
Anwaltskanzlei	Anwaltskanzleis
Anweisung	Anweisungen
Anwendung	Anwendungen
Anwesenheit	—
Anwohnerin	Anwohnerinnen
Anzahl	Anzahlen
Anzahlung	Anzahlungen
Anzeige	Anzeigen
Anzeigetafel	Anzeigetafeln
Anziehungskraft	Anziehungskräfte
Apartheid	—
Apokalypse	Apokalypsen
Apotheke	Apotheken
Apparatur	Apparaturen
Applikation	Applikationen
Arbeit	Arbeiten
Arbeiterbewegung	Arbeiterbewegungen
Arbeiterin	Arbeiterinnen
Arbeiterkammer	Arbeiterkammern
Arbeiterklasse	Arbeiterklassen
Arbeiterpartei	Arbeiterparteien
Arbeiterschaft	—
Arbeiterwohlfahrt	Arbeiterwohlfahrten
Arbeitgeberseite	—
Arbeitnehmerin	Arbeitnehmerinnen
Arbeitnehmervertretung	Arbeitnehmervertretungen
Arbeitsagentur	Arbeitsagenturen
Arbeitsbedingung	Arbeitsbedingungen
Arbeitserlaubnis	Arbeitserlaubnisse
Arbeitsgemeinschaft	Arbeitsgemeinschaften
Arbeitsgruppe	Arbeitsgruppen
Arbeitskraft	Arbeitskräfte
Arbeitsleistung	Arbeitsleistungen
Arbeitslose	Arbeitslosen
Arbeitslosenhilfe	Arbeitslosenhilfen
Arbeitslosenquote	Arbeitslosenquoten
Arbeitslosenrate	Arbeitslosenraten
Arbeitslosenversicherung	Arbeitslosenversicherungen
Arbeitslosenzahl	Arbeitslosenzahlen
Arbeitslosigkeit	Arbeitslosigkeiten
Arbeitsmarktpolitik	Arbeitsmarktpolitiken
Arbeitsmarktreform	Arbeitsmarktreformen
Arbeitsniederlegung	Arbeitsniederlegungen
Arbeitsorganisation	Arbeitsorganisationen
Arbeitsstelle	Arbeitsstellen
Arbeitsstunde	Arbeitsstunden
Arbeitsteilung	Arbeitsteilungen
Arbeitsvermittlung	Arbeitsvermittlungen
Arbeitsweise	Arbeitsweisen
Arbeitswelt	Arbeitswelten
Arbeitszeit	Arbeitszeiten
Arche	Archen
Architektin	Architektinnen
Architektur	Architekturen
Are	Aren
Arena	Arenas
Argumentation	Argumentationen
Ari	Aris
Arie	Arien
Arkade	Arkaden
Arktis	—
Armada	Armaden	Armadas
Armatur	Armaturen
Armbanduhr	Armbanduhren
Armee	Armeen
Armut	—
Armutsgrenze	Armutsgrenzen
Arroganz	Arroganzen
Art	Arten
Artenvielfalt	—
Artikulation	Artikulationen
Artillerie	Artillerien
Artistik	—
Arznei	Arzneis
Arzthelferin	Arzthelferinnen
Arztpraxis	Arztpraxen
Asche	Aschen
Askese	Askesen
Assekuranz	Assekuranzen
Assistentin	Assistentinnen
Assoziation	Assoziationen
Astrologie	—
Astronomie	Astronomien
Asylpolitik	Asylpolitiken
Atemnot	—
Atempause	Atempausen
Athletin	Athletinnen
Atmung	Atmungen
Atomanlage	Atomanlagen
Atombombe	Atombomben
Atomenergie	Atomenergien
Atomindustrie	Atomindustrien
Atomkraft	Atomkräfte
Atommacht	Atommächte
Atompolitik	—
Atomwaffe	Atomwaffen
Attacke	Attacken
Attrappe	Attrappen
Audienz	Audienzen
Aufarbeitung	Aufarbeitungen
Aufbauarbeit	Aufbauarbeiten
Aufbereitung	Aufbereitungen
Aufbewahrung	—
Aufbruchstimmung	Aufbruchstimmungen
Aufdeckung	Aufdeckungen
Aufenthaltserlaubnis	Aufenthaltserlaubnisse
Aufenthaltsgenehmigung	Aufenthaltsgenehmigungen
Auferstehung	Auferstehungen
Auffahrt	Auffahrten
Auffanggesellschaft	Auffanggesellschaften
Auffassung	Auffassungen
Aufforderung	Aufforderungen
Aufführung	Aufführungen
Aufgabe	Aufgaben
Aufgabenstellung	Aufgabenstellungen
Aufhebung	Aufhebungen
Aufholjagd	Aufholjagden
Aufklärung	Aufklärungen
Auflage	Auflagen
Auflistung	Auflistungen
Auflösung	Auflösungen
Aufmachung	Aufmachungen
Aufmerksamkeit	Aufmerksamkeiten
Aufnahme	Aufnahmen
Aufrechterhaltung	Aufrechterhaltungen
Aufregung	Aufregungen
Aufrichtigkeit	Aufrichtigkeiten
Aufschrift	Aufschriften
Aufsicht	Aufsichten
Aufsichtsratssitzung	Aufsichtsratssitzungen
Aufspaltung	Aufspaltungen
Aufstellung	Aufstellungen
Aufstiegschance	Aufstiegschancen
Aufstiegsrunde	Aufstiegsrunden
Aufstockung	Aufstockungen
Auftaktveranstaltung	Auftaktveranstaltungen
Aufteilung	Aufteilungen
Auftragsarbeit	Auftragsarbeiten
Auftragslage	Auftragslagen
Auftragsvergabe	Auftragsvergaben
Aufwartung	Aufwartungen
Aufweichung	Aufweichungen
Aufwendung	Aufwendungen
Aufwertung	Aufwertungen
Aufzeichnung	Aufzeichnungen
Aufzucht	Aufzuchten
Aufzug	Aufzüge
Augenbraue	Augenbrauen
Augenweide	Augenweiden
Auktion	Auktionen
Aula	Aulen	Aulas
Aura	Auren
Ausarbeitung	Ausarbeitungen
Ausbaustufe	Ausbaustufen
Ausbeute	Ausbeuten
Ausbeutung	Ausbeutungen
Ausbildung	Ausbildungen
Ausbildungsstelle	Ausbildungsstellen
Ausbildungszeit	Ausbildungszeiten
Ausbreitung	Ausbreitungen
Ausdauer	—
Ausdehnung	Ausdehnungen
Ausdruckskraft	Ausdruckskräfte
Ausdrucksweise	Ausdrucksweisen
Auseinandersetzung	Auseinandersetzungen
Ausfahrt	Ausfahrten
Ausfuhr	Ausfuhren
Ausführung	Ausführungen
Ausgabe	Ausgaben
Ausgangslage	Ausgangslagen
Ausgangsposition	Ausgangspositionen
Ausgangssperre	Ausgangssperren
Ausgeglichenheit	Ausgeglichenheiten
Ausgestaltung	Ausgestaltungen
Ausgewogenheit	Ausgewogenheiten
Ausgleichszahlung	Ausgleichszahlungen
Ausgliederung	Ausgliederungen
Ausgrabung	Ausgrabungen
Ausgrenzung	Ausgrenzungen
Aushilfe	Aushilfen
Auskunft	Auskünfte
Auslage	Auslagen
Auslagerung	Auslagerungen
Auslandsinvestition	Auslandsinvestitionen
Auslandsreise	Auslandsreisen
Auslastung	Auslastungen
Auslegung	Auslegungen
Ausleihe	Ausleihen
Auslese	Auslesen
Auslieferung	Auslieferungen
Auslosung	Auslosungen
Ausnahme	Ausnahmen
Ausnahmegenehmigung	Ausnahmegenehmigungen
Ausnahmeregelung	Ausnahmeregelungen
Ausnutzung	Ausnutzungen
Ausrede	Ausreden
Ausreise	Ausreisen
Ausrichtung	Ausrichtungen
Ausrottung	Ausrottungen
Ausrufung	Ausrufungen
Aussage	Aussagen
Aussagekraft	—
Ausschau	—
Ausscheidung	Ausscheidungen
Ausschreibung	Ausschreibungen
Ausschreitung	Ausschreitungen
Ausschusssitzung	Ausschusssitzungen
Aussendung	Aussendungen
Aussetzung	Aussetzungen
Aussicht	Aussichten
Aussprache	Aussprachen
Ausstattung	Ausstattungen
Ausstellung	Ausstellungen
Ausstellungshalle	Ausstellungshallen
Ausstrahlung	Ausstrahlungen
Auster	Austern
Austragung	Austragungen
Australierin	Australierinnen
Auswahl	Auswahlen
Auswanderung	Auswanderungen
Auswechslung	Auswechslungen
Ausweiche	Ausweichen
Ausweisung	Ausweisungen
Ausweitung	Ausweitungen
Auswertung	Auswertungen
Auswirkung	Auswirkungen
Auszahlung	Auszahlungen
Auszeichnung	Auszeichnungen
Auszeit	Auszeiten
Autobahn	Autobahnen
Autobahnpolizei	Autobahnpolizeien
Autobiografie	Autobiografien
Autobombe	Autobomben
Autofahrerin	Autofahrerinnen
Autofahrt	Autofahrten
Autofirma	Autofirmen
Autogrammstunde	Autogrammstunden
Autoindustrie	Autoindustrien
Automarke	Automarken
Automatik	Automatiken
Automation	Automationen
Automatisierung	Automatisierungen
Automobilindustrie	Automobilindustrien
Autonomie	Autonomien
Autopsie	Autopsien
Autorin	Autorinnen
Autorität	Autoritäten
Autostunde	Autostunden
Avantgarde	Avantgarden
Avenue	Avenuen
Axt	Äxte
Backstube	Backstuben
Badehose	Badehosen
Badesaison	—
Badewanne	Badewannen
Bahn	Bahnen
Bahnfahrt	Bahnfahrten
Bahnlinie	Bahnlinien
Bahnstation	Bahnstationen
Bahnstrecke	Bahnstrecken
Baisse	Baissen
Balance	Balancen
Ballade	Balladen
Banane	Bananen
Bandage	Bandagen
Bandbreite	Bandbreiten
Bande	Banden
Bange	—
Banja	Banjas
Bankenaufsicht	Bankenaufsichten
Bankengruppe	Bankengruppen
Bankfiliale	Bankfilialen
Bankgesellschaft	Bankgesellschaften
Banknote	Banknoten
Bar	Bars
Baracke	Baracken
Barbarei	Barbareien
Barmherzigkeit	—
Barriere	Barrieren
Barrikade	Barrikaden
Base	Basen
Basilika	Basiliken
Basis	Basen
Bastille	Bastillen
Bastion	Bastionen
Batterie	Batterien
Bauart	Bauarten
Bauaufsicht	Bauaufsichten
Baubewilligung	Baubewilligungen
Baubranche	Baubranchen
Bauchspeicheldrüse	Bauchspeicheldrüsen
Bauernfamilie	Bauernfamilien
Bauernpartei	Bauernparteien
Baufirma	Baufirmen
Baugenehmigung	Baugenehmigungen
Baugesellschaft	Baugesellschaften
Baugrube	Baugruben
Bauindustrie	Bauindustrien
Baukommission	Baukommissionen
Baukonjunktur	Baukonjunkturen
Baukunst	Baukünste
Bauleistung	Bauleistungen
Baumaschine	Baumaschinen
Baumschule	Baumschulen
Baumwolle	Baumwollen
Bauordnung	Bauordnungen
Baureihe	Baureihen
Bausparkasse	Bausparkassen
Baustelle	Baustellen
Bausubstanz	Bausubstanzen
Bauweise	Bauweisen
Bauwirtschaft	—
Bauzeit	Bauzeiten
Bavaria	—
Beachtung	—
Beamtengewerkschaft	Beamtengewerkschaften
Beamtenpension	Beamtenpensionen
Beamtin	Beamtinnen
Beanstandung	Beanstandungen
Beantwortung	Beantwortungen
Bearbeitung	Bearbeitungen
Beauftragte	Beauftragten
Beauty	Beautys
Bebauung	Bebauungen
Bedenkzeit	—
Bedeutung	Bedeutungen
Bedeutungslosigkeit	Bedeutungslosigkeiten
Bedienung	Bedienungen
Bedingung	Bedingungen
Bedrohung	Bedrohungen
Beeilung	Beeilungen
Beeinflussung	Beeinflussungen
Beendigung	Beendigungen
Beerdigung	Beerdigungen
Beere	Beeren
Befangenheit	—
Befestigung	Befestigungen
Befindlichkeit	Befindlichkeiten
Befragte	Befragten
Befragung	Befragungen
Befreiung	Befreiungen
Befreiungsbewegung	Befreiungsbewegungen
Befriedigung	Befriedigungen
Befriedung	Befriedungen
Befristung	Befristungen
Befruchtung	Befruchtungen
Befugnis	Befugnisse
Beförderung	Beförderungen
Befürchtung	Befürchtungen
Begabung	Begabungen
Begebenheit	Begebenheiten
Begegnung	Begegnungen
Begehrlichkeit	Begehrlichkeiten
Begehung	Begehungen
Begeisterung	Begeisterungen
Begierde	Begierden
Begleiterin	Begleiterinnen
Begleiterscheinung	Begleiterscheinungen
Begleitperson	Begleitpersonen
Begleitung	Begleitungen
Begnadigung	Begnadigungen
Begrenzung	Begrenzungen
Begründung	Begründungen
Begrüßung	Begrüßungen
Begutachtung	Begutachtungen
Behandlung	Behandlungen
Behandlungsmethode	Behandlungsmethoden
Beharrlichkeit	—
Behauptung	Behauptungen
Behausung	Behausungen
Behebung	Behebungen
Beherrschung	Beherrschungen
Behinderte	Behinderten
Behinderung	Behinderungen
Behörde	Behörden
Beibehaltung	Beibehaltungen
Beichte	Beichten
Beifahrerin	Beifahrerinnen
Beihilfe	Beihilfen
Beilage	Beilagen
Beilegung	Beilegungen
Beisetzung	Beisetzungen
Beitrittsverhandlung	Beitrittsverhandlungen
Bekanntgabe	Bekanntgaben
Bekanntheit	Bekanntheiten
Bekanntmachung	Bekanntmachungen
Bekanntschaft	Bekanntschaften
Bekleidung	Bekleidungen
Belagerung	Belagerungen
Belastbarkeit	Belastbarkeiten
Belastung	Belastungen
Belebung	Belebungen
Belegschaft	Belegschaften
Belegung	Belegungen
Belehrung	Belehrungen
Beleidigung	Beleidigungen
Beleuchtung	Beleuchtungen
Beliebigkeit	Beliebigkeiten
Beliebtheit	—
Belletristik	—
Belohnung	Belohnungen
Belästigung	Belästigungen
Bemerkung	Bemerkungen
Bemessungsgrundlage	Bemessungsgrundlagen
Bemühung	Bemühungen
Benachteiligung	Benachteiligungen
Benefizveranstaltung	Benefizveranstaltungen
Benennung	Benennungen
Benutzung	Benutzungen
Beobachtung	Beobachtungen
Bepflanzung	Bepflanzungen
Bequemlichkeit	Bequemlichkeiten
Beraterin	Beraterinnen
Beratung	Beratungen
Beratungsfirma	Beratungsfirmen
Beratungsstelle	Beratungsstellen
Berechnung	Berechnungen
Berechtigung	Berechtigungen
Bereicherung	Bereicherungen
Bereinigung	Bereinigungen
Bereitschaft	Bereitschaften
Bereitschaftspolizei	Bereitschaftspolizeien
Bereitstellung	Bereitstellungen
Bergbahn	Bergbahnen
Bergregion	Bergregionen
Bergstation	Bergstationen
Bergtour	Bergtouren
Bergung	Bergungen
Bergungsarbeit	Bergungsarbeiten
Bergwacht	Bergwachten
Bergwelt	Bergwelten
Berichterstattung	Berichterstattungen
Berichtigung	Berichtigungen
Berlinerin	Berlinerinnen
Berufsakademie	Berufsakademien
Berufsausbildung	Berufsausbildungen
Berufsberatung	Berufsberatungen
Berufsbezeichnung	Berufsbezeichnungen
Berufsbildung	Berufsbildungen
Berufserfahrung	Berufserfahrungen
Berufsfeuerwehr	Berufsfeuerwehren
Berufsgenossenschaft	Berufsgenossenschaften
Berufsgruppe	Berufsgruppen
Berufsschule	Berufsschulen
Berufswahl	—
Berufung	Berufungen
Beruhigung	Beruhigungen
Berühmtheit	Berühmtheiten
Berührung	Berührungen
Besatzung	Besatzungen
Besatzungsmacht	Besatzungsmächte
Besatzungszone	Besatzungszonen
Beschaffenheit	Beschaffenheiten
Beschaffung	Beschaffungen
Bescheidenheit	Bescheidenheiten
Bescheinigung	Bescheinigungen
Bescherung	Bescherungen
Beschilderung	Beschilderungen
Beschimpfung	Beschimpfungen
Beschlagnahme	Beschlagnahmen
Beschleunigung	Beschleunigungen
Beschlussfassung	Beschlussfassungen
Beschneidung	Beschneidungen
Beschreibung	Beschreibungen
Beschuldigung	Beschuldigungen
Beschwerde	Beschwerden
Beschwörung	Beschwörungen
Beschädigung	Beschädigungen
Beschäftigung	Beschäftigungen
Beseitigung	Beseitigungen
Besessenheit	—
Besetzung	Besetzungen
Besichtigung	Besichtigungen
Besiedlung	Besiedlungen
Besinnung	Besinnungen
Besitzerin	Besitzerinnen
Besoldung	Besoldungen
Besonderheit	Besonderheiten
Besonnenheit	Besonnenheiten
Besorgnis	Besorgnisse
Besprechung	Besprechungen
Besserung	Besserungen
Bestandsaufnahme	Bestandsaufnahmen
Bestattung	Bestattungen
Bestbesetzung	Bestbesetzungen
Bestechlichkeit	—
Bestechung	Bestechungen
Bestellung	Bestellungen
Besteuerung	Besteuerungen
Bestform	Bestformen
Bestie	Bestien
Bestimmung	Bestimmungen
Bestleistung	Bestleistungen
Bestmarke	Bestmarken
Bestnote	Bestnoten
Bestrafung	Bestrafungen
Bestrahlung	Bestrahlungen
Bestrebung	Bestrebungen
Bestsellerliste	Bestsellerlisten
Bestzeit	Bestzeiten
Bestätigung	Bestätigungen
Besucherin	Besucherinnen
Besucherzahl	Besucherzahlen
Bete	Beten
Beteiligte	Beteiligten
Beteiligung	Beteiligungen
Beteiligungsgesellschaft	Beteiligungsgesellschaften
Beteuerung	Beteuerungen
Betonung	Betonungen
Betrachtung	Betrachtungen
Betrachtungsweise	Betrachtungsweisen
Betreiberfirma	Betreiberfirmen
Betreibergesellschaft	Betreibergesellschaften
Betreiberin	Betreiberinnen
Betreuerin	Betreuerinnen
Betreuung	Betreuungen
Betriebsamkeit	—
Betriebsgesellschaft	Betriebsgesellschaften
Betriebskrankenkasse	Betriebskrankenkassen
Betriebsrente	Betriebsrenten
Betriebsvereinbarung	Betriebsvereinbarungen
Betriebsversammlung	Betriebsversammlungen
Betriebswirtschaft	—
Betriebswirtschaftslehre	—
Betroffenheit	Betroffenheiten
Bettwäsche	Bettwäschen
Betäubung	Betäubungen
Beule	Beulen
Beunruhigung	Beunruhigungen
Beurteilung	Beurteilungen
Beute	Beuten
Beutekunst	—
Bevormundung	Bevormundungen
Bevorzugung	Bevorzugungen
Bewachung	Bewachungen
Bewaffnung	Bewaffnungen
Bewahrung	Bewahrungen
Beweglichkeit	Beweglichkeiten
Bewegung	Bewegungen
Bewegungsfreiheit	Bewegungsfreiheiten
Beweisaufnahme	Beweisaufnahmen
Beweislage	Beweislagen
Beweislast	Beweislasten
Bewerberin	Bewerberinnen
Bewerbung	Bewerbungen
Bewerbungsfrist	Bewerbungsfristen
Bewertung	Bewertungen
Bewilligung	Bewilligungen
Bewirtschaftung	Bewirtschaftungen
Bewirtung	Bewirtungen
Bewohnerin	Bewohnerinnen
Bewunderung	Bewunderungen
Bewährung	Bewährungen
Bewässerung	Bewässerungen
Bezahlung	Bezahlungen
Bezeichnung	Bezeichnungen
Beziehung	Beziehungen
Bezirkshauptmannschaft	Bezirkshauptmannschaften
Bezirksklasse	Bezirksklassen
Bezirksliga	Bezirksligen
Bezirksregierung	Bezirksregierungen
Bezirksstadt	Bezirksstädte
Bezirksverordnetenversammlung	Bezirksverordnetenversammlungen
Bezugsperson	Bezugspersonen
Bibel	Bibeln
Bibliothek	Bibliotheken
Biene	Bienen
Biennale	Biennalen
Bierdose	Bierdosen
Bierflasche	Bierflaschen
Bilanz	Bilanzen
Bilanzpressekonferenz	Bilanzpressekonferenzen
Bilanzsumme	Bilanzsummen
Bildhauerei	Bildhauereien
Bildhauerin	Bildhauerinnen
Bildsprache	Bildsprachen
Bildung	Bildungen
Bildungseinrichtung	Bildungseinrichtungen
Bildungsministerin	Bildungsministerinnen
Bildungspolitik	—
Bildunterschrift	Bildunterschriften
Billigung	Billigungen
Billion	Billionen
Binde	Binden
Bindung	Bindungen
Binge	Bingen
Binnennachfrage	Binnennachfragen
Binsenweisheit	Binsenweisheiten
Biochemie	—
Bioethik	—
Biografie	Biografien
Biologie	—
Biologin	Biologinnen
Biomasse	—
Biotechnologie	—
Biotonne	Biotonnen
Birke	Birken
Birne	Birnen
Bischofskonferenz	Bischofskonferenzen
Bitte	Bitten
Bitterkeit	Bitterkeiten
Blamage	Blamagen
Blase	Blasen
Blaskapelle	Blaskapellen
Blasmusik	Blasmusiken
Blasphemie	Blasphemien
Bleibe	Bleiben
Bleiche	Bleichen
Blessur	Blessuren
Blindheit	—
Blockade	Blockaden
Blondine	Blondinen
Blume	Blumen
Bluse	Blusen
Blutkonserve	Blutkonserven
Blutprobe	Blutproben
Blutspende	Blutspenden
Blutspur	Blutspuren
Bluttat	Bluttaten
Blutung	Blutungen
Bodenhaftung	Bodenhaftungen
Bodenreform	Bodenreformen
Bodentruppe	Bodentruppen
Bohle	Bohlen
Bohne	Bohnen
Bohrung	Bohrungen
Bombardierung	Bombardierungen
Bombe	Bomben
Bombendrohung	Bombendrohungen
Bora	Boras
Borke	Borken
Borussia	—
Bosheit	Bosheiten
Botanik	—
Botschaft	Botschaften
Botschafterin	Botschafterinnen
Boulevardpresse	—
Boulevardzeitung	Boulevardzeitungen
Bourgeoisie	Bourgeoisien
Boutique	Boutiquen
Box	Boxen
Brache	Brachen
Branche	Branchen
Brandkatastrophe	Brandkatastrophen
Brandstiftung	Brandstiftungen
Brandung	Brandungen
Brandursache	Brandursachen
Bratwurst	Bratwürste
Brauerei	Brauereien
Braunkohle	Braunkohlen
Brause	Brausen
Braut	Bräute
Bravour	Bravouren
Breche	Brechen
Bredouille	Bredouillen
Breite	Breiten
Bremerin	Bremerinnen
Brennstoffzelle	Brennstoffzellen
Bresche	Breschen
Bretagne	—
Brezel	Brezeln
Briefbombe	Briefbomben
Briefmarke	Briefmarken
Brieftasche	Brieftaschen
Briefwahl	Briefwahlen
Brigade	Brigaden
Brillanz	Brillanzen
Brille	Brillen
Brisanz	—
Brise	Brisen
Britin	Britinnen
Bronchitis	Bronchitiden
Bronze	Bronzen
Bronzemedaille	Bronzemedaillen
Broschüre	Broschüren
Bruchlandung	Bruchlandungen
Bruderschaft	Bruderschaften
Brunst	Brünste
Brust	Brüste
Brut	Bruten
Brutalität	Brutalitäten
Bräune	Bräunen
Brücke	Brücken
Buche	Buchen
Buchform	Buchformen
Buchhaltung	Buchhaltungen
Buchhandlung	Buchhandlungen
Buchmesse	Buchmessen
Buchpreisbindung	—
Bucht	Buchten
Buchung	Buchungen
Bude	Buden
Budgetierung	Budgetierungen
Bundesagentur	Bundesagenturen
Bundesanstalt	Bundesanstalten
Bundesanwaltschaft	Bundesanwaltschaften
Bundesbahn	Bundesbahnen
Bundesbank	—
Bundesebene	—
Bundesgartenschau	Bundesgartenschauen
Bundesgesundheitsministerin	Bundesgesundheitsministerinnen
Bundeshauptstadt	Bundeshauptstädte
Bundesjustizministerin	Bundesjustizministerinnen
Bundeskanzlerin	Bundeskanzlerinnen
Bundesliga	Bundesligen
Bundesministerin	Bundesministerinnen
Bundespartei	Bundesparteien
Bundespolitik	Bundespolitiken
Bundespolizei	Bundespolizeien
Bundespost	—
Bundesregierung	Bundesregierungen
Bundesrepublik	Bundesrepubliken
Bundestagsfraktion	Bundestagsfraktionen
Bundestagswahl	Bundestagswahlen
Bundesvereinigung	Bundesvereinigungen
Bundesverfassung	Bundesverfassungen
Bundesversammlung	Bundesversammlungen
Bundeswehr	—
Bundeszentrale	Bundeszentralen
Burg	Burgen	Bürge
Burgruine	Burgruinen
Burschenschaft	Burschenschaften
Busfahrt	Busfahrten
Bushaltestelle	Bushaltestellen
Buslinie	Buslinien
Busspur	Busspuren
Butter	—
Buße	Bußen
Bäckerei	Bäckereis
Bücherei	Büchereis
Büchse	Büchsen
Bürde	Bürden
Bürokratie	Bürokratien
Bürste	Bürsten
CPU	CPUs
Cafeteria	Cafeterien	Cafeterias
Caritas	—
Causa	Causae	Causen
Chance	Chancen
Chancenauswertung	Chancenauswertungen
Chancengleichheit	—
Charakterisierung	Charakterisierungen
Charge	Chargen
Charta	Chartas
Chase	Chases
Chaussee	Chausseen
Checkliste	Checklisten
Chefetage	Chefetagen
Chefin	Chefinnen
Chefredakteurin	Chefredakteurinnen
Chefredaktion	Chefredaktionen
Chefsache	Chefsachen
Chemie	Chemien
Chemieindustrie	Chemieindustrien
Chemikalie	Chemikalien
Chemotherapie	Chemotherapien
Chiffre	Chiffren
Chinesin	Chinesinnen
Chipkarte	Chipkarten
Chirurg	Chirurgen
Chirurgie	Chirurgien
Cholera	—
Choreografie	Choreografien
Christin	Christinnen
Chronik	Chroniken
Chronologie	Chronologien
City	Citys
Clique	Cliquen
Coca	Coca	Cocas
Cola	Colas
Collage	Collagen
Colonia	Coloniae
Combo	Combos
Comedy	Comedys
Compagnie	Compagnien
Computerfirma	Computerfirmen
Computersimulation	Computersimulationen
Computertechnik	Computertechniken
Couch	Couches
Couleur	Couleurs	Couleuren
County	Countys
Courage	Couragen
Cousine	Cousinen
Couture	—
Coverversion	Coverversionen	Coverversions
Crew	Crews
Currywurst	Currywürste
Dachorganisation	Dachorganisationen
Dachterrasse	Dachterrassen
Damentoilette	Damentoiletten
Dampflok	Dampfloks
Dankbarkeit	Dankbarkeiten
Darbietung	Darbietungen
Darstellerin	Darstellerinnen
Darstellung	Darstellungen
Datei	Dateis
Datenautobahn	Datenautobahnen
Datenbank	Datenbanken
Datenmenge	Datenmengen
Datenverarbeitung	Datenverarbeitungen
Dauer	Dauern
Dauerausstellung	Dauerausstellungen
Dauerkarte	Dauerkarten
Debatte	Debatten
Decke	Decken
Deckung	Deckungen
Defensive	Defensiven
Definition	Definitionen
Deflation	Deflationen
Dekade	Dekaden
Dekadenz	—
Deklaration	Deklarationen
Dekoration	Dekorationen
Delegation	Delegationen
Delegiertenversammlung	Delegiertenversammlungen
Delikatesse	Delikatessen
Delle	Dellen
Demenz	Demenzen
Demission	Demissionen
Demo	Demos
Demokratie	Demokratien
Demokratiebewegung	Demokratiebewegungen
Demokratisierung	Demokratisierungen
Demonstrantin	Demonstrantinnen
Demonstration	Demonstrationen
Demontage	Demontagen
Demut	—
Demütigung	Demütigungen
Denkmalpflege	—
Denkweise	Denkweisen
Denunziation	Denunziationen
Deponie	Deponien
Deportation	Deportationen
Depression	Depressionen
Deregulierung	Deregulierungen
Designerin	Designerinnen
Destabilisierung	Destabilisierungen
Destination	Destinationen
Detailfrage	Detailfragen
Deutlichkeit	Deutlichkeiten
Deutschkenntnis	Deutschkenntnisse
Deutung	Deutungen
Devise	Devisen
Devisenreserve	Devisenreserven
Dezentralisierung	Dezentralisierungen
Diagnose	Diagnosen
Diagnostik	Diagnostiken
Diagonale	Diagonalen
Diakonie	Diakonien
Dialektik	—
Diaspora	—
Dichte	Dichten
Dichterin	Dichterinnen
Dichtung	Dichtungen
Dienstleistung	Dienstleistungen
Dienstleistungsgewerkschaft	Dienstleistungsgewerkschaften
Dienstreise	Dienstreisen
Dienststelle	Dienststellen
Dienstzeit	Dienstzeiten
Diffamierung	Diffamierungen
Differenz	Differenzen
Differenzierung	Differenzierungen
Digitalisierung	Digitalisierungen
Digitalkamera	Digitalkameras
Diktatur	Diktaturen
Diktion	Diktionen
Dimension	Dimensionen
Diplomarbeit	Diplomarbeiten
Diplomatie	Diplomatien
Direktbank	Direktbanken
Direktinvestition	Direktinvestitionen
Direktion	Direktionen
Direktive	Direktiven
Direktorin	Direktorinnen
Direktwahl	Direktwahlen
Direktzahlung	Direktzahlungen
Dirigentin	Dirigentinnen
Disc	Discs
Disco	Discos
Diskette	Disketten
Diskothek	Diskotheken
Diskrepanz	Diskrepanzen
Diskretion	Diskretionen
Diskriminierung	Diskriminierungen
Diskussion	Diskussionen
Diskussionsrunde	Diskussionsrunden
Diskussionsveranstaltung	Diskussionsveranstaltungen
Disposition	Dispositionen
Disqualifikation	Disqualifikationen
Dissertation	Dissertationen
Dissonanz	Dissonanzen
Distanz	Distanzen
Distanzierung	Distanzierungen
Distel	Disteln
Distribution	Distributionen
Disziplin	Disziplinen
Diva	Divas
Dividende	Dividenden
Division	Divisionen
Doktorarbeit	Doktorarbeiten
Doktrin	Doktrinen
Doku	Dokus
Dokumentation	Dokumentationen
Dolmetscherin	Dolmetscherinnen
Domain	Domains
Dominanz	Dominanzen
Donau	—
Donna	Donnas	Donnen
Dopingkontrolle	Dopingkontrollen
Doppelbelastung	Doppelbelastungen
Doppelfunktion	Doppelfunktionen
Doppelmoral	—
Doppelrolle	Doppelrollen
Doppelspitze	Doppelspitzen
Dorferneuerung	Dorferneuerungen
Dorfgemeinschaft	Dorfgemeinschaften
Dorfkirche	Dorfkirchen
Dose	Dosen
Dosierung	Dosierungen
Dosis	Dosen
Dozentin	Dozentinnen
Dramatik	—
Dramaturgie	Dramaturgien
Drau	—
Dreharbeit	Dreharbeiten
Drehleiter	Drehleitern
Drehscheibe	Drehscheiben
Drehung	Drehungen
Drehzahl	Drehzahlen
Dreiviertelstunde	Dreiviertelstunden
Dressur	Dressuren
Dringlichkeit	—
Droge	Drogen
Drogenbehörde	Drogenbehörden
Drogenpolitik	Drogenpolitiken
Drogensucht	Drogensüchte
Drogenszene	Drogenszenen
Drogerie	Drogerien
Drohung	Drohungen
Druckerei	Druckereien
Druckmaschine	Druckmaschinen
Drüse	Drüsen
Duldung	Duldungen
Dummheit	Dummheiten
Dunkelheit	Dunkelheiten
Dunkelziffer	Dunkelziffern
Durchblutung	Durchblutungen
Durchfahrt	Durchfahrten
Durchführung	Durchführungen
Durchreise	Durchreisen
Durchsage	Durchsagen
Durchschlagskraft	Durchschlagskräfte
Durchsetzung	—
Durchsicht	Durchsichten
Durchsuchung	Durchsuchungen
Durststrecke	Durststrecken
Dusche	Duschen
Dynamik	Dynamiken
Dynastie	Dynastien
Dämmerung	Dämmerungen
Düse	Düsen
Ebbe	Ebben
Ebene	Ebenen
Echtheit	—
Echtzeit	—
Ecke	Ecken
Ecker	Eckern
Edition	Editionen
Effizienz	Effizienzen
Effizienzsteigerung	Effizienzsteigerungen
Ehe	Ehen
Ehefrau	Ehefrauen
Ehre	Ehren
Ehrennadel	Ehrennadeln
Ehrenrunde	Ehrenrunden
Ehrensache	Ehrensachen
Ehrfurcht	—
Ehrlichkeit	—
Ehrung	Ehrungen
Eiche	Eichen
Eichel	Eicheln
Eidgenossenschaft	Eidgenossenschaften
Eifel	—
Eifersucht	—
Eigenart	Eigenarten
Eigendynamik	Eigendynamiken
Eigenheimzulage	Eigenheimzulagen
Eigenheit	Eigenheiten
Eigeninitiative	Eigeninitiativen
Eigenkapitalquote	Eigenkapitalquoten
Eigenkomposition	Eigenkompositionen
Eigenleistung	Eigenleistungen
Eigenproduktion	Eigenproduktionen
Eigenregie	Eigenregien
Eigenschaft	Eigenschaften
Eigentumswohnung	Eigentumswohnungen
Eigenverantwortung	Eigenverantwortungen
Eigenwerbung	Eigenwerbungen
Eignung	Eignungen
Eile	—
Einberufung	Einberufungen
Einbeziehung	Einbeziehungen
Einbildung	Einbildungen
Einbindung	Einbindungen
Einbringung	Einbringungen
Eindeutigkeit	Eindeutigkeiten
Einfachheit	Einfachheiten
Einfahrt	Einfahrten
Einflussnahme	Einflussnahmen
Einfuhr	Einfuhren
Einführung	Einführungen
Eingabe	Eingaben
Eingangshalle	Eingangshallen
Eingangstür	Eingangstüren
Eingemeindung	Eingemeindungen
Eingliederung	Eingliederungen
Eingreiftruppe	Eingreiftruppen
Einhaltung	Einhaltungen
Einheit	Einheiten
Einheitsgemeinde	Einheitsgemeinden
Einheitspartei	Einheitsparteien
Einigkeit	Einigkeiten
Einigung	Einigungen
Einkaufsmeile	Einkaufsmeilen
Einkaufstour	Einkaufstouren
Einkehr	—
Einkommensgrenze	Einkommensgrenzen
Einkommenssteuer	Einkommenssteuern
Einkommensteuer	Einkommensteuern
Einladung	Einladungen
Einlage	Einlagen
Einlassung	Einlassungen
Einleitung	Einleitungen
Einlieferung	Einlieferungen
Einmalzahlung	Einmalzahlungen
Einmischung	Einmischungen
Einnahme	Einnahmen
Einnahmequelle	Einnahmequellen
Einordnung	Einordnungen
Einreichung	Einreichungen
Einreise	Einreisen
Einrichtung	Einrichtungen
Eins	Einsen
Einsamkeit	Einsamkeiten
Einsatzbereitschaft	—
Einsatzgruppe	Einsatzgruppen
Einsatzkraft	Einsatzkräfte
Einsatzleitung	Einsatzleitungen
Einschaltquote	Einschaltquoten
Einschaltung	Einschaltungen
Einschränkung	Einschränkungen
Einschulung	Einschulungen
Einschätzung	Einschätzungen
Einsendung	Einsendungen
Einsetzung	Einsetzungen
Einsicht	Einsichten
Einsparung	Einsparungen
Einspielung	Einspielungen
Einsprache	Einsprachen
Einstellung	Einstellungen
Einstimmung	Einstimmungen
Einstufung	Einstufungen
Eintagsfliege	Eintagsfliegen
Einteilung	Einteilungen
Eintracht	—
Eintragung	Eintragungen
Eintrittskarte	Eintrittskarten
Einvernahme	Einvernahmen
Einwanderung	Einwanderungen
Einwanderungsbehörde	Einwanderungsbehörden
Einwanderungspolitik	—
Einwechslung	Einwechslungen
Einweihung	Einweihungen
Einweisung	Einweisungen
Einwendung	Einwendungen
Einwilligung	Einwilligungen
Einwirkung	Einwirkungen
Einwohnerin	Einwohnerinnen
Einwohnerzahl	Einwohnerzahlen
Einzahlung	Einzahlungen
Einzelgewerkschaft	Einzelgewerkschaften
Einzelhaft	—
Einzelheit	Einzelheiten
Einzelleistung	Einzelleistungen
Einzelperson	Einzelpersonen
Einzelwertung	Einzelwertungen
Einzigartigkeit	Einzigartigkeiten
Einöde	Einöden
Eisbahn	Eisbahnen
Eiscreme	Eiscremen
Eisenbahn	Eisenbahnen
Eisenbahngesellschaft	Eisenbahngesellschaften
Eisenbahnlinie	Eisenbahnlinien
Eisenstange	Eisenstangen
Eishalle	Eishallen
Eissporthalle	Eissporthallen
Eiszeit	Eiszeiten
Eitelkeit	Eitelkeiten
Eizelle	Eizellen
Ekstase	Ekstasen
Elbe	—
Eleganz	—
Elegie	Elegien
Elektrizität	Elektrizitäten
Elektrode	Elektroden
Elektroindustrie	Elektroindustrien
Elektronik	—
Elektrotechnik	—
Elfe	Elfen
Elite	Eliten
Elle	Ellen
Eltern	—
Elterninitiative	Elterninitiativen
Emanzipation	Emanzipationen
Emigration	Emigrationen
Eminenz	Eminenzen
Emission	Emissionen
Emotion	Emotionen
Empfehlung	Empfehlungen
Empfindlichkeit	Empfindlichkeiten
Empfindung	Empfindungen
Empore	Emporen
Endabrechnung	Endabrechnungen
Endlagerung	Endlagerungen
Endphase	Endphasen
Endrunde	Endrunden
Endstation	Endstationen
Endzeit	Endzeiten
Energie	Energien
Energieeinsparung	Energieeinsparungen
Energieerzeugung	—
Energiegewinnung	Energiegewinnungen
Energiepolitik	—
Energiequelle	Energiequellen
Energiesteuer	Energiesteuern
Energieversorgung	—
Energiewirtschaft	—
Enge	Engen
Enkelin	Enkelinnen
Enklave	Enklaven
Enquete	Enqueten
Entbehrung	Entbehrungen
Entbindung	Entbindungen
Entdeckung	Entdeckungen
Entdeckungsreise	Entdeckungsreisen
Ente	Enten
Enteignung	Enteignungen
Entfaltung	Entfaltungen
Entfernung	Entfernungen
Entflechtung	Entflechtungen
Entfremdung	Entfremdungen
Entführer	Entführer
Entführung	Entführungen
Entgleisung	Entgleisungen
Enthaltung	Enthaltungen
Enthüllung	Enthüllungen
Entlassung	Entlassungen
Entlastung	Entlastungen
Entlohnung	Entlohnungen
Entmachtung	Entmachtungen
Entnahme	Entnahmen
Entscheidung	Entscheidungen
Entscheidungsfindung	Entscheidungsfindungen
Entschiedenheit	Entschiedenheiten
Entschlossenheit	Entschlossenheiten
Entschuldigung	Entschuldigungen
Entschuldung	Entschuldungen
Entschädigung	Entschädigungen
Entsendung	Entsendungen
Entsorgung	Entsorgungen
Entspannung	Entspannungen
Entsprechung	Entsprechungen
Entstehung	Entstehungen
Entstehungsgeschichte	Entstehungsgeschichten
Enttäuschung	Enttäuschungen
Entwaffnung	Entwaffnungen
Entwarnung	Entwarnungen
Entwicklung	Entwicklungen
Entwicklungshilfe	Entwicklungshilfen
Entwicklungspolitik	Entwicklungspolitiken
Entwicklungszusammenarbeit	Entwicklungszusammenarbeiten
Entzündung	Entzündungen
Epidemie	Epidemien
Episode	Episoden
Equipe	Equipen	Equipes
Erarbeitung	Erarbeitungen
Erbanlage	Erbanlagen
Erbin	Erbinnen
Erbkrankheit	Erbkrankheiten
Erbschaft	Erbschaften
Erbschaftssteuer	Erbschaftssteuern
Erbschaftsteuer	Erbschaftsteuern
Erbse	Erbsen
Erbsubstanz	Erbsubstanzen
Erdatmosphäre	Erdatmosphären
Erdbeere	Erdbeeren
Erde	Erden
Erdnussbutter	Erdnussbutter
Erdoberfläche	Erdoberflächen
Erfahrung	Erfahrungen
Erfassung	Erfassungen
Erfindung	Erfindungen
Erfolglosigkeit	—
Erfolgsaussicht	Erfolgsaussichten
Erfolgsbilanz	Erfolgsbilanzen
Erfolgschance	Erfolgschancen
Erfolgsgeschichte	Erfolgsgeschichten
Erfolgsmeldung	Erfolgsmeldungen
Erfolgsquote	Erfolgsquoten
Erfolgsserie	Erfolgsserien
Erfolgsstory	Erfolgsstorys
Erforschung	Erforschungen
Erfrischung	Erfrischungen
Erfüllung	Erfüllungen
Ergreifung	Ergreifungen
Erhaltung	Erhaltungen
Erhebung	Erhebungen
Erholung	Erholungen
Erhöhung	Erhöhungen
Erinnerung	Erinnerungen
Erkennung	—
Erklärung	Erklärungen
Erkrankung	Erkrankungen
Erkundung	Erkundungen
Erkältung	Erkältungen
Erlangung	—
Erlaubnis	Erlaubnisse
Erle	Erlen
Erlebniswelt	Erlebniswelten
Erledigung	Erledigungen
Erleichterung	Erleichterungen
Erleuchtung	Erleuchtungen
Erlösung	Erlösungen
Ermahnung	Ermahnungen
Ermangelung	—
Ermittlung	Ermittlungen
Ermittlungsgruppe	Ermittlungsgruppen
Ermordung	Ermordungen
Ermutigung	Ermutigungen
Ernennung	Ernennungen
Erneuerung	Erneuerungen
Erniedrigung	Erniedrigungen
Ernsthaftigkeit	—
Ernte	Ernten
Ernährung	Ernährungen
Eroberung	Eroberungen
Erosion	Erosionen
Erotik	Erotiken
Erpressung	Erpressungen
Erprobung	Erprobungen
Erregung	Erregungen
Erreichbarkeit	Erreichbarkeiten
Erreichung	—
Errichtung	Errichtungen
Errungenschaft	Errungenschaften
Ersatzbank	Ersatzbanken
Ersatzkasse	Ersatzkassen
Ersatzwahl	Ersatzwahlen
Erschaffung	Erschaffungen
Erscheinung	Erscheinungen
Erscheinungsform	Erscheinungsformen
Erschöpfung	Erschöpfungen
Ersparnis	Ersparnisse
Erstarrung	Erstarrungen
Erstattung	Erstattungen
Erstausgabe	Erstausgaben
Erstellung	Erstellungen
Erststimme	Erststimmen
Erstversorgung	Erstversorgungen
Erteilung	Erteilungen
Ertragslage	Ertragslagen
Eruption	Eruptionen
Erwachsenenbildung	—
Erwartung	Erwartungen
Erwartungshaltung	Erwartungshaltungen
Erweiterung	Erweiterungen
Erwerbsarbeit	Erwerbsarbeiten
Erwähnung	Erwähnungen
Erwärmung	Erwärmungen
Erzeugung	Erzeugungen
Erzieherin	Erzieherinnen
Erziehung	Erziehungen
Erzählung	Erzählungen
Eröffnung	Eröffnungen
Esche	Eschen
Eskalation	Eskalationen
Eskapade	Eskapaden
Eskorte	Eskorten
Esoterik	—
Essenz	Essenzen
Etablierung	Etablierungen
Etage	Etagen
Etappe	Etappen
Ethik	Ethiken
Ethnie	Ethnien
Eucharistiefeier	Eucharistiefeiern
Eule	Eulen
Euphorie	Euphorien
Europaliga	Europaligen
Europameisterin	Europameisterinnen
Europameisterschaft	Europameisterschaften
Europapolitik	Europapolitiken
Europawahl	Europawahlen
Eurovision	—
Eurozone	—
Euthanasie	—
Eva	Evas	Even
Evakuierung	Evakuierungen
Evaluation	Evaluationen
Evolution	Evolutionen
Ewigkeit	Ewigkeiten
Exchange	Exchangen	Exchanges
Exekution	Exekutionen
Exekutive	Exekutiven
Existenz	Existenzen
Existenzberechtigung	Existenzberechtigungen
Exkursion	Exkursionen
Exotik	—
Expansion	Expansionen
Expedition	Expeditionen
Experte	Experten
Expertengruppe	Expertengruppen
Expertenkommission	Expertenkommissionen
Expertin	Expertinnen
Expertise	Expertisen
Explosion	Explosionen
Expo	Expos
Exportwirtschaft	Exportwirtschaften
Exposition	Expositionen
Extraklasse	Extraklassen
Exzellenz	Exzellenzen
Fabel	Fabeln
Fabrik	Fabriken
Fabrikhalle	Fabrikhallen
Face	Faces
Facette	Facetten
Fachabteilung	Fachabteilungen
Fachfrau	Fachfrauen
Fachgruppe	Fachgruppen
Fachhochschule	Fachhochschulen
Fachkenntnis	Fachkenntnisse
Fachkompetenz	Fachkompetenzen
Fachkraft	Fachkräfte
Fachliteratur	Fachliteraturen
Fachmesse	Fachmessen
Fachrichtung	Fachrichtungen
Fachschule	Fachschulen
Fachtagung	Fachtagungen
Fachwelt	Fachwelten
Fachzeitschrift	Fachzeitschriften
Fackel	Fackeln
Fahndung	Fahndungen
Fahne	Fahnen
Fahrbahn	Fahrbahnen
Fahrerflucht	—
Fahrerin	Fahrerinnen
Fahrerlaubnis	Fahrerlaubnisse
Fahrkarte	Fahrkarten
Fahrleistung	Fahrleistungen
Fahrschule	Fahrschulen
Fahrspur	Fahrspuren
Fahrt	Fahrten
Fahrtrichtung	Fahrtrichtungen
Fahrweise	Fahrweisen
Fahrzeit	Fahrzeiten
Fairness	—
Falle	Fallen
Falltür	Falltüren
Falschaussage	Falschaussagen
Falte	Falten
Familie	Familien
Familienbeihilfe	Familienbeihilfen
Familiengeschichte	Familiengeschichten
Familienministerin	Familienministerinnen
Familienplanung	Familienplanungen
Familienpolitik	Familienpolitiken
Fanfare	Fanfaren
Fangemeinde	Fangemeinden
Fantasie	Fantasien
Farbe	Farben
Farbgebung	Farbgebungen
Farbigkeit	Farbigkeiten
Farce	Farcen
Farm	Farmen
Faser	Fasern
Fashion	—
Fassade	Fassaden
Fassung	Fassungen
Fastenzeit	Fastenzeiten
Fastnacht	—
Faszination	Faszinationen
Faulheit	Faulheiten
Fauna	Faunen
Faustfeuerwaffe	Faustfeuerwaffen
Faustregel	Faustregeln
Favoritenrolle	Favoritenrollen
Favoritin	Favoritinnen
Faxe	Faxen
Feature	Features
Feder	Federn
Fee	Feen
Fehde	Fehden
Fehlanzeige	Fehlanzeigen
Fehlentscheidung	Fehlentscheidungen
Fehlentwicklung	Fehlentwicklungen
Fehlfunktion	Fehlfunktionen
Fehlleistung	Fehlleistungen
Feier	Feiern
Feierlichkeit	Feierlichkeiten
Feierstunde	Feierstunden
Feige	Feigen
Feigheit	—
Feindschaft	Feindschaften
Feindseligkeit	Feindseligkeiten
Feinheit	Feinheiten
Feinunze	Feinunzen
Felswand	Felswände
Feministin	Feministinnen
Fensterscheibe	Fensterscheiben
Ferien	Ferien
Ferieninsel	Ferieninseln
Ferienwoche	Ferienwochen
Ferienwohnung	Ferienwohnungen
Ferienzeit	Ferienzeiten
Fernbedienung	Fernbedienungen
Ferne	Fernen
Fernreise	Fernreisen
Fernsehansprache	Fernsehansprachen
Fernsehanstalt	Fernsehanstalten
Fernsehkamera	Fernsehkameras
Fernsehsendung	Fernsehsendungen
Fernsehserie	Fernsehserien
Fernsehshow	Fernsehshows
Fernsehstation	Fernsehstationen
Ferse	Fersen
Fertigkeit	Fertigkeiten
Fertigstellung	Fertigstellungen
Fertigung	Fertigungen
Feste	Festen
Festhalle	Festhallen
Festigkeit	Festigkeiten
Festigung	Festigungen
Festlegung	Festlegungen
Festlichkeit	Festlichkeiten
Festnahme	Festnahmen
Festplatte	Festplatten
Festrede	Festreden
Festschreibung	Festschreibungen
Festschrift	Festschriften
Festsetzung	Festsetzungen
Feststellung	Feststellungen
Festung	Festungen
Festveranstaltung	Festveranstaltungen
Festwoche	Festwochen
Fete	Feten
Feuchtigkeit	Feuchtigkeiten
Feuerpause	Feuerpausen
Feuerstelle	Feuerstellen
Feuertaufe	Feuertaufen
Feuerwache	Feuerwachen
Feuerwehr	Feuerwehren
Fidel	Fideln
Fiesta	Fiestas
Figur	Figuren
Fiktion	Fiktionen
Filiale	Filialen
Filmemacherin	Filmemacherinnen
Filmgeschichte	Filmgeschichten
Filmindustrie	—
Filmkunst	Filmkünste
Filmmusik	Filmmusiken
Filmproduktion	Filmproduktionen
Filmreihe	Filmreihen
Filmrolle	Filmrollen
Finalrunde	Finalrunden
Finanz	Finanzen
Finanzdienstleistung	Finanzdienstleistungen
Finanzhilfe	Finanzhilfen
Finanzierung	Finanzierungen
Finanzkraft	Finanzkräfte
Finanzkrise	Finanzkrisen
Finanzlage	Finanzlagen
Finanznot	Finanznöte
Finanzplanung	Finanzplanungen
Finanzpolitik	Finanzpolitiken
Finanzsenatorin	Finanzsenatorinnen
Finanzsituation	Finanzsituationen
Finanzspritze	Finanzspritzen
Finanzverwaltung	Finanzverwaltungen
Finanzwelt	Finanzwelten
Finesse	Finessen
Finsternis	Finsternisse
Firma	Firmas
Firmengeschichte	Firmengeschichten
Firmengruppe	Firmengruppen
Fischerei	Fischereien
Fitness	—
Fixierung	Fixierungen
Flagge	Flaggen
Flamme	Flammen
Flanke	Flanken
Flasche	Flaschen
Flaute	Flauten
Fledermaus	Fledermäuse
Flexibilisierung	Flexibilisierungen
Fliege	Fliegen
Fliese	Fliesen
Flinte	Flinten
Flora	Floras
Floskel	Floskeln
Flotte	Flotten
Flucht	Fluchten
Fluchtgefahr	—
Flugbahn	Flugbahnen
Flugbewegung	Flugbewegungen
Fluggesellschaft	Fluggesellschaften
Fluglinie	Fluglinien
Flugreise	Flugreisen
Flugsicherung	Flugsicherungen
Flugstunde	Flugstunden
Fluktuation	Fluktuationen
Flut	Fluten
Flutkatastrophe	Flutkatastrophen
Flutwelle	Flutwellen
Fläche	Flächen
Flöte	Flöten
Flüssigkeit	Flüssigkeiten
Folge	Folgen
Folgerung	Folgerungen
Folgezeit	Folgezeiten
Folklore	—
Folter	Foltern
Folterung	Folterungen
Fondsgesellschaft	Fondsgesellschaften
Force	Forces
Forderung	Forderungen
Forelle	Forellen
Form	Formen
Formalität	Formalitäten
Formation	Formationen
Formel	Formeln
Formensprache	Formensprachen
Formsache	Formsachen
Formulierung	Formulierungen
Forschergruppe	Forschergruppen
Forscherin	Forscherinnen
Forschung	Forschungen
Forschungsanstalt	Forschungsanstalten
Forschungsarbeit	Forschungsarbeiten
Forschungseinrichtung	Forschungseinrichtungen
Forschungsgemeinschaft	Forschungsgemeinschaften
Forschungsgruppe	Forschungsgruppen
Forstwirtschaft	Forstwirtschaften
Fortbewegung	Fortbewegungen
Fortbildung	Fortbildungen
Fortentwicklung	Fortentwicklungen
Fortpflanzung	—
Fortschreibung	Fortschreibungen
Fortsetzung	Fortsetzungen
Fortune	—
Fotografie	Fotografien
Fotografin	Fotografinnen
Fracht	Frachten
Frage	Fragen
Fragestellung	Fragestellungen
Fragestunde	Fragestunden
Fraktion	Fraktionen
Fraktionschefin	Fraktionschefinnen
Fraktionssitzung	Fraktionssitzungen
Frankfurterin	Frankfurterinnen
Frau	Frauen
Frauenbeauftragte	Frauenbeauftragten
Frauenbewegung	Frauenbewegungen
Frauenfrage	Frauenfragen
Frauengruppe	Frauengruppen
Frauenklinik	Frauenkliniken
Frauenministerin	Frauenministerinnen
Frauenorganisation	Frauenorganisationen
Frauenpolitik	Frauenpolitiken
Frauenquote	Frauenquoten
Frauenstimme	Frauenstimmen
Frauenzeitschrift	Frauenzeitschriften
Frechheit	Frechheiten
Fregatte	Fregatten
Freigabe	Freigaben
Freihandelszone	Freihandelszonen
Freiheit	Freiheiten
Freiheitsberaubung	Freiheitsberaubungen
Freiheitsstrafe	Freiheitsstrafen
Freikarte	Freikarten
Freilassung	Freilassungen
Freisetzung	Freisetzungen
Freistellung	Freistellungen
Freiwilligkeit	—
Freizeit	Freizeiten
Freizeiteinrichtung	Freizeiteinrichtungen
Freizeitgestaltung	Freizeitgestaltungen
Fremdenfeindlichkeit	Fremdenfeindlichkeiten
Fremdenpolizei	Fremdenpolizeien
Fremdheit	—
Fremdsprache	Fremdsprachen
Frequenz	Frequenzen
Freude	Freuden
Freundin	Freundinnen
Freundlichkeit	Freundlichkeiten
Freundschaft	Freundschaften
Friedensbewegung	Friedensbewegungen
Friedensinitiative	Friedensinitiativen
Friedenskonferenz	Friedenskonferenzen
Friedensmission	Friedensmissionen
Friedenspolitik	Friedenspolitiken
Friedenssicherung	Friedenssicherungen
Friedenstruppe	Friedenstruppen
Friedensverhandlung	Friedensverhandlungen
Frische	—
Frist	Fristen
Frisur	Frisuren
Front	Fronten
Frucht	Früchte
Fruchtbarkeit	—
Frustration	Frustrationen
Fundgrube	Fundgruben
Fundstelle	Fundstellen
Funkausstellung	Funkausstellungen
Funkstille	Funkstillen
Funktion	Funktionen
Funktionsweise	Funktionsweisen
Furche	Furchen
Furcht	—
Furore	—
Fusion	Fusionen
Fußspur	Fußspuren
Fähigkeit	Fähigkeiten
Fälschung	Fälschungen
Fäulnis	—
Föderation	Föderationen
Förderung	Förderungen
Fügung	Fügungen
Führung	Führungen
Füllung	Füllungen
Fürsorge	Fürsorgen
Gabe	Gaben
Gabel	Gabeln
Gage	Gagen
Gala	Galas
Galaxie	Galaxien
Galerie	Galerien
Galeristin	Galeristinnen
Galionsfigur	Galionsfiguren
Galopprennbahn	Galopprennbahnen
Gangart	Gangarten
Gans	Gänse
Ganztagsschule	Ganztagsschulen
Garage	Garagen
Garantie	Garantien
Garde	Garden
Garderobe	Garderoben
Gardine	Gardinen
Garnele	Garnelen
Garnison	Garnisonen
Garnitur	Garnituren
Gartenanlage	Gartenanlagen
Gartenarbeit	Gartenarbeiten
Gartenschau	Gartenschauen
Gartenstadt	Gartenstädte
Gasexplosion	Gasexplosionen
Gasflasche	Gasflaschen
Gaskammer	Gaskammern
Gasleitung	Gasleitungen
Gaspistole	Gaspistolen
Gasse	Gassen
Gastfamilie	Gastfamilien
Gastfreundschaft	Gastfreundschaften
Gastgeberin	Gastgeberinnen
Gastronomie	Gastronomien
Gattin	Gattinnen
Gattung	Gattungen
Gaumenfreude	Gaumenfreuden
Gazette	Gazetten
Gebietskrankenkasse	Gebietskrankenkassen
Gebietsreform	Gebietsreformen
Geborgenheit	—
Gebrauchsanweisung	Gebrauchsanweisungen
Geburt	Geburten
Geburtenrate	Geburtenraten
Geburtshilfe	Geburtshilfen
Geburtsstadt	Geburtsstädte
Geburtsstunde	Geburtsstunden
Geburtstagsfeier	Geburtstagsfeiern
Gebärmutter	Gebärmütter
Gedenkfeier	Gedenkfeiern
Gedenktafel	Gedenktafeln
Gedenkveranstaltung	Gedenkveranstaltungen
Geduld	—
Gefahr	Gefahren
Gefahrenzone	Gefahrenzonen
Gefangenschaft	Gefangenschaften
Gefolgschaft	Gefolgschaften
Gefährdung	Gefährdungen
Gefängnisstrafe	Gefängnisstrafen
Gegebenheit	Gegebenheiten
Gegend	Gegenden
Gegendarstellung	Gegendarstellungen
Gegenfahrbahn	Gegenfahrbahnen
Gegenfinanzierung	Gegenfinanzierungen
Gegenleistung	Gegenleistungen
Gegenliebe	—
Gegenrichtung	Gegenrichtungen
Gegenseite	Gegenseiten
Gegenstimme	Gegenstimmen
Gegenwart	—
Gegenwartskunst	Gegenwartskünste
Gegenwehr	Gegenwehren
Gegenüberstellung	Gegenüberstellungen
Gegnerin	Gegnerinnen
Gegnerschaft	Gegnerschaften
Gehaltserhöhung	Gehaltserhöhungen
Gehaltsliste	Gehaltslisten
Geheimhaltung	Geheimhaltungen
Geheimniskrämerei	Geheimniskrämereis
Geheimpolizei	Geheimpolizeien
Geige	Geigen
Geigerin	Geigerinnen
Geisel	Geisel
Geiselhaft	—
Geiselnahme	Geiselnahmen
Geisteswissenschaft	Geisteswissenschaften
Gelassenheit	—
Geldanlage	Geldanlagen
Geldbörse	Geldbörsen
Geldmenge	Geldmengen
Geldnot	Geldnöte
Geldpolitik	Geldpolitiken
Geldquelle	Geldquellen
Geldspende	Geldspenden
Geldstrafe	Geldstrafen
Geldtasche	Geldtaschen
Geldwäsche	Geldwäschen
Gelegenheit	Gelegenheiten
Gelehrte	Gelehrten
Geliebte	Geliebten
Geltung	—
Gemahlin	Gemahlinnen
Gemarkung	Gemarkungen
Gemeinde	Gemeinden
Gemeindeordnung	Gemeindeordnungen
Gemeinderatssitzung	Gemeinderatssitzungen
Gemeinderatswahl	Gemeinderatswahlen
Gemeindeversammlung	Gemeindeversammlungen
Gemeindevertretung	Gemeindevertretungen
Gemeindeverwaltung	Gemeindeverwaltungen
Gemeindewahl	Gemeindewahlen
Gemeinheit	Gemeinheiten
Gemeinsamkeit	Gemeinsamkeiten
Gemeinschaft	Gemeinschaften
Gemütlichkeit	Gemütlichkeiten
Genauigkeit	Genauigkeiten
Gendarmerie	Gendarmerien
Genehmigung	Genehmigungen
Generaldirektion	Generaldirektionen
Generalprobe	Generalproben
Generalsanierung	Generalsanierungen
Generalstaatsanwaltschaft	Generalstaatsanwaltschaften
Generalversammlung	Generalversammlungen
Generation	Generationen
Genesis	Genesen
Genesung	Genesungen
Genetik	—
Genialität	Genialitäten
Genossenschaft	Genossenschaften
Genossenschaftsbank	Genossenschaftsbanken
Genossin	Genossinnen
Gens	Gentes
Gentechnik	Gentechniken
Gentechnologie	Gentechnologien
Gentherapie	Gentherapien
Genugtuung	Genugtuungen
Geografie	Geografien
Geologie	Geologien
Geometrie	Geometrien
Gepflogenheit	Gepflogenheiten
Gera	—
Gerade	Geraden
Gerechtigkeit	Gerechtigkeiten
Gerichtsbarkeit	Gerichtsbarkeiten
Gerichtsentscheidung	Gerichtsentscheidungen
Gerichtsverhandlung	Gerichtsverhandlungen
Germania	—
Germanistik	—
Gesamtausgabe	Gesamtausgaben
Gesamtheit	Gesamtheiten
Gesamtleistung	Gesamtleistungen
Gesamtschule	Gesamtschulen
Gesamtsumme	Gesamtsummen
Gesamtwertung	Gesamtwertungen
Gesamtzahl	Gesamtzahlen
Geschichte	Geschichten
Geschichtsschreibung	Geschichtsschreibungen
Geschichtswissenschaft	Geschichtswissenschaften
Geschicklichkeit	Geschicklichkeiten
Geschlossenheit	Geschlossenheiten
Geschmacklosigkeit	Geschmacklosigkeiten
Geschwindigkeit	Geschwindigkeiten
Geschwindigkeitsbegrenzung	Geschwindigkeitsbegrenzungen
Geschäftsleitung	Geschäftsleitungen
Geschäftsreise	Geschäftsreisen
Geselligkeit	Geselligkeiten
Gesellschaft	Gesellschaften
Gesellschaftsordnung	Gesellschaftsordnungen
Gesetzesinitiative	Gesetzesinitiativen
Gesetzesnovelle	Gesetzesnovellen
Gesetzesvorlage	Gesetzesvorlagen
Gesetzgebung	Gesetzgebungen
Gesinnung	Gesinnungen
Gestalt	Gestalten
Gestaltung	Gestaltungen
Gestapo	—
Geste	Gesten
Gestik	—
Gesundheit	Gesundheiten
Gesundheitsbehörde	Gesundheitsbehörden
Gesundheitsministerin	Gesundheitsministerinnen
Gesundheitspolitik	Gesundheitspolitiken
Gesundheitsreform	Gesundheitsreformen
Gesundheitsversorgung	Gesundheitsversorgungen
Gesundheitsvorsorge	—
Gesundung	—
Gewalt	Gewalten
Gewaltanwendung	Gewaltanwendungen
Gewaltbereitschaft	Gewaltbereitschaften
Gewaltenteilung	—
Gewalttat	Gewalttaten
Gewerbeordnung	Gewerbeordnungen
Gewerbeschau	Gewerbeschauen
Gewerbesteuer	Gewerbesteuern
Gewerkschaft	Gewerkschaften
Gewichtsklasse	Gewichtsklassen
Gewichtung	Gewichtungen
Gewinnchance	Gewinnchancen
Gewinnerin	Gewinnerinnen
Gewinnmitnahme	Gewinnmitnahmen
Gewinnung	Gewinnungen
Gewinnzone	Gewinnzonen
Gewissheit	Gewissheiten
Gewohnheit	Gewohnheiten
Gier	—
Gilde	Gilden
Giraffe	Giraffen
Gitarre	Gitarren
Glanzleistung	Glanzleistungen
Glanzzeit	Glanzzeiten
Glasfaser	Glasfasern
Glasnost	—
Glasscheibe	Glasscheiben
Glatze	Glatzen
Glaubensgemeinschaft	Glaubensgemeinschaften
Gleichbehandlung	Gleichbehandlungen
Gleichberechtigung	Gleichberechtigungen
Gleichgültigkeit	Gleichgültigkeiten
Gleichheit	Gleichheiten
Gleichsetzung	Gleichsetzungen
Gleichstellung	Gleichstellungen
Gleichung	Gleichungen
Gliederung	Gliederungen
Gliedmaße	Gliedmaßen
Globalisierung	Globalisierungen
Glocke	Glocken
Glosse	Glossen
Glut	Gluten
Glückseligkeit	Glückseligkeiten
Glückszahl	Glückszahlen
Glühbirne	Glühbirnen
Gnade	Gnaden
Goldmedaille	Goldmedaillen
Goldmine	Goldminen
Goldreserve	Goldreserven
Gondel	Gondeln
Gottheit	Gottheiten
Grabung	Grabungen
Grafik	Grafiken
Grafschaft	Grafschaften
Grammatik	Grammatiken
Granate	Granaten
Gratulation	Gratulationen
Gratwanderung	Gratwanderungen
Grausamkeit	Grausamkeiten
Grauzone	Grauzonen
Grenze	Grenzen
Grenzkontrolle	Grenzkontrollen
Grenzpolizei	—
Grenzregion	Grenzregionen
Grenzstadt	Grenzstädte
Grenztruppe	Grenztruppen
Grenzziehung	Grenzziehungen
Grille	Grillen
Grimasse	Grimassen
Grippe	Grippen
Grippewelle	Grippewellen
Groteske	Grotesken
Grotte	Grotten
Großeltern	—
Großmama	Großmamas
Großmutter	Großmütter
Großstadt	Großstädte
Großzügigkeit	Großzügigkeiten
Grube	Gruben
Gruft	Grüfte
Grundausbildung	Grundausbildungen
Grundausstattung	Grundausstattungen
Grundfeste	Grundfesten
Grundfrage	Grundfragen
Grundhaltung	Grundhaltungen
Grundidee	Grundideen
Grundkenntnis	Grundkenntnisse
Grundlage	Grundlagen
Grundlagenforschung	Grundlagenforschungen
Grundlinie	Grundlinien
Grundmauer	Grundmauern
Grundordnung	Grundordnungen
Grundregel	Grundregeln
Grundsatzentscheidung	Grundsatzentscheidungen
Grundsatzfrage	Grundsatzfragen
Grundschule	Grundschulen
Grundsicherung	Grundsicherungen
Grundsteinlegung	Grundsteinlegungen
Grundsteuer	Grundsteuern
Grundstimmung	Grundstimmungen
Grundversorgung	Grundversorgungen
Grundvoraussetzung	Grundvoraussetzungen
Gruppe	Gruppen
Gruppenarbeit	Gruppenarbeiten
Gruppierung	Gruppierungen
Gräfin	Gräfinnen
Gründung	Gründungen
Gunst	Gunsten
Gurke	Gurken
Gymnastik	—
Gänsehaut	—
Gästeliste	Gästelisten
Göttlichkeit	Göttlichkeiten
Habe	—
Habgier	—
Habilitation	Habilitationen
Hacken	Hacken
Hafenstadt	Hafenstädte
Haftanstalt	Haftanstalten
Haftentlassung	Haftentlassungen
Haftpflicht	Haftpflichten
Haftpflichtversicherung	Haftpflichtversicherungen
Haftstrafe	Haftstrafen
Halbe	Halben	Halbe
Halbierung	Halbierungen
Halbinsel	Halbinseln
Halbpension	—
Halbzeit	Halbzeiten
Halbzeitpause	Halbzeitpausen
Halde	Halden
Halfpipe	Halfpipes
Halle	Hallen
Halluzination	Halluzinationen
Halse	Halsen
Haltbarkeit	Haltbarkeiten
Haltestelle	Haltestellen
Haltung	Haltungen
Hamburgerin	Hamburgerinnen
Hand	Hände
Handarbeit	Handarbeiten
Handballerin	Handballerinnen
Handbewegung	Handbewegungen
Handelsakademie	Handelsakademien
Handelsbeziehung	Handelsbeziehungen
Handelsbilanz	Handelsbilanzen
Handelskammer	Handelskammern
Handelskette	Handelsketten
Handelsschule	Handelsschulen
Handfläche	Handflächen
Handgranate	Handgranaten
Handgreiflichkeit	Handgreiflichkeiten
Handhabe	Handhaben
Handhabung	—
Handlung	Handlungen
Handschelle	Handschellen
Handschrift	Handschriften
Handtasche	Handtaschen
Handvoll	Handvoll
Handwerkskammer	Handwerkskammern
Hanke	Hanken
Hanse	—
Hansestadt	Hansestädte
Hardware	Hardwaren
Harfe	Harfen
Harmonie	Harmonien
Harmonika	Harmonikas	Harmoniken
Harmonisierung	Harmonisierungen
Hast	—
Hatz	Hatzen
Haube	Hauben
Hauptabteilung	Hauptabteilungen
Hauptangeklagte	Hauptangeklagten
Hauptattraktion	Hauptattraktionen
Hauptaufgabe	Hauptaufgaben
Hauptdarstellerin	Hauptdarstellerinnen
Hauptfigur	Hauptfiguren
Hauptlast	Hauptlasten
Hauptperson	Hauptpersonen
Hauptrolle	Hauptrollen
Hauptrunde	Hauptrunden
Hauptsache	Hauptsachen
Hauptschule	Hauptschulen
Hauptstadt	Hauptstädte
Hauptursache	Hauptursachen
Hauptverhandlung	Hauptverhandlungen
Hauptversammlung	Hauptversammlungen
Hauptverwaltung	Hauptverwaltungen
Hauptwache	Hauptwachen
Hausarbeit	Hausarbeiten
Hausaufgabe	Hausaufgaben
Hausbank	Hausbanken
Hausdurchsuchung	Hausdurchsuchungen
Hausfrau	Hausfraus
Haushaltsberatung	Haushaltsberatungen
Haushaltsdebatte	Haushaltsdebatten
Haushaltshilfe	Haushaltshilfen
Haushaltskonsolidierung	Haushaltskonsolidierungen
Haushaltslage	Haushaltslagen
Haushaltspolitik	Haushaltspolitiken
Haushaltssperre	Haushaltssperren
Hausnummer	Hausnummern
Hausse	Haussen
Haustechnik	Haustechniken
Haustür	Haustüren
Hausverwaltung	Hausverwaltungen
Hauswand	Hauswände
Haut	Häute
Hautfarbe	Hautfarben
Havarie	Havarien
Havel	—
Hebamme	Hebammen
Hebung	Hebungen
Heerschar	Heerscharen
Hefe	Hefen
Heftigkeit	Heftigkeiten
Hegemonie	Hegemonien
Hehlerei	Hehlereien
Heilige	Heiligen
Heilsarmee	—
Heilung	Heilungen
Heimat	Heimaten
Heimatgemeinde	Heimatgemeinden
Heimatstadt	Heimatstädte
Heimfahrt	Heimfahrten
Heimkehr	—
Heimniederlage	Heimniederlagen
Heimreise	Heimreisen
Heimstatt	—
Heirat	Heiraten
Heiterkeit	Heiterkeiten
Heizung	Heizungen
Heizungsanlage	Heizungsanlagen
Hektare	Hektaren
Hektik	—
Heldentat	Heldentaten
Heldin	Heldinnen
Helferin	Helferinnen
Helle	—
Helligkeit	Helligkeiten
Hemisphäre	Hemisphären
Hemmschwelle	Hemmschwellen
Hemmung	Hemmungen
Henne	Hennen
Hepatitis	Hepatititiden
Herabsetzung	Herabsetzungen
Herausforderung	Herausforderungen
Herausgabe	Herausgaben
Herausgeberin	Herausgeberinnen
Herberge	Herbergen
Herbstmesse	Herbstmessen
Herde	Herden
Herkunft	Herkünfte
Heroinabgabe	Heroinabgaben
Herrenmannschaft	Herrenmannschaften
Herrin	Herrinnen
Herrlichkeit	Herrlichkeiten
Herrschaft	Herrschaften
Herstellerfirma	Herstellerfirmen
Herstellung	Herstellungen
Herzegowina	—
Herzenslust	—
Herzlichkeit	Herzlichkeiten
Herzogin	Herzoginnen
Herzoperation	Herzoperationen
Hetze	Hetzen
Hetzjagd	Hetzjagden
Heuchelei	Heucheleis
Heuschrecke	Heuschrecken
Hexe	Hexen
Hexerei	Hexereis
Hierarchie	Hierarchien
Hilfe	Hilfen
Hilfeleistung	Hilfeleistungen
Hilfestellung	Hilfestellungen
Hilflosigkeit	—
Hilfsaktion	Hilfsaktionen
Hilfsbereitschaft	—
Hilfskraft	Hilfskräfte
Hilfslieferung	Hilfslieferungen
Hilfsorganisation	Hilfsorganisationen
Himmelfahrt	Himmelfahrten
Himmelsrichtung	Himmelsrichtungen
Hingabe	Hingaben
Hinkunft	Hinkünfte
Hinrichtung	Hinrichtungen
Hinsicht	Hinsichten
Hinterachse	Hinterachsen
Hinterbliebene	Hinterbliebenen
Hinterhand	—
Hinterlassenschaft	Hinterlassenschaften
Hintertür	Hintertüren
Hinwendung	Hinwendungen
Hiobsbotschaft	Hiobsbotschaften
Historie	Historien
Historikerin	Historikerinnen
Hitliste	Hitlisten
Hitparade	Hitparaden
Hitze	Hitzen
Hitzewelle	Hitzewellen
Hochachtung	Hochachtungen
Hochburg	Hochburgen
Hochform	Hochformen
Hochkonjunktur	Hochkonjunkturen
Hochkultur	Hochkulturen
Hochrechnung	Hochrechnungen
Hochsaison	—
Hochschule	Hochschulen
Hochspannung	Hochspannungen
Hochstimmung	—
Hochtechnologie	Hochtechnologien
Hochtour	Hochtouren
Hochzeit	Hochzeiten
Hoffnung	Hoffnungen
Hoffnungslosigkeit	—
Hoheit	Hoheiten
Holding	Holdings
Hommage	Hommagen
Horde	Horden
Hose	Hosen
Hosentasche	Hosentaschen
Hotelkette	Hotelketten
Hotellerie	—
Hotline	Hotlines
Hube	Huben
Huldigung	Huldigungen
Hunderasse	Hunderassen
Hundert	—
Hundertschaft	Hundertschaften
Hundertstelsekunde	Hundertstelsekunden
Hungersnot	Hungersnöte
Hupe	Hupen
Hure	Huren
Hygiene	Hygienen
Hymne	Hymnen
Hypnose	Hypnosen
Hypothek	Hypotheken
Hypothekenbank	Hypothekenbanken
Hypothese	Hypothesen
Hysterie	Hysterien
Hyäne	Hyänen
Hälfte	Hälften
Hängematte	Hängematten
Härte	Härten
Höhe	Höhen
Höhle	Höhlen
Hülle	Hüllen
Hülse	Hülsen
Hütte	Hütten
Idee	Ideen
Identifikation	Identifikationen
Identifizierung	Identifizierungen
Identität	Identitäten
Ideologie	Ideologien
Idylle	Idyllen
Ignoranz	—
Ikone	Ikonen
Illusion	Illusionen
Illustration	Illustrationen
Imagination	Imaginationen
Imbissbude	Imbissbuden
Imitation	Imitationen
Immobilie	Immobilien
Immobilienfirma	Immobilienfirmen
Immobiliengesellschaft	Immobiliengesellschaften
Immunität	Immunitäten
Impfung	Impfungen
Implementierung	Implementierungen
Impression	Impressionen
Improvisation	Improvisationen
Inanspruchnahme	Inanspruchnahmen
Inbetriebnahme	Inbetriebnahmen
Inbrunst	—
Indikation	Indikationen
Indiskretion	Indiskretionen
Individualisierung	Individualisierungen
Industrialisierung	Industrialisierungen
Industrie	Industrien
Industrieanlage	Industrieanlagen
Industriegesellschaft	Industriegesellschaften
Industriegewerkschaft	Industriegewerkschaften
Industriellenvereinigung	Industriellenvereinigungen
Industrienation	Industrienationen
Industriepolitik	Industriepolitiken
Industrieproduktion	Industrieproduktionen
Industriestadt	Industriestädte
Infanterie	Infanterien
Infektion	Infektionen
Infektionskrankheit	Infektionskrankheiten
Inflation	Inflationen
Inflationsrate	Inflationsraten
Influenza	—
Informatik	—
Information	Informationen
Informationsgesellschaft	Informationsgesellschaften
Informationspolitik	Informationspolitiken
Informationsquelle	Informationsquellen
Informationsstelle	Informationsstellen
Informationstechnik	—
Informationstechnologie	Informationstechnologien
Informationsveranstaltung	Informationsveranstaltungen
Infrastruktur	Infrastrukturen
Infusion	Infusionen
Inhaberin	Inhaberinnen
Inhaftierung	Inhaftierungen
Initiale	Initialen
Initiative	Initiativen
Initiatorin	Initiatorinnen
Injektion	Injektionen
Inkarnation	Inkarnationen
Inkompetenz	Inkompetenzen
Inlandsnachfrage	Inlandsnachfragen
Inlandspresse	—
Innenausstattung	Innenausstattungen
Inneneinrichtung	Inneneinrichtungen
Innenministerkonferenz	Innenministerkonferenzen
Innenpolitik	—
Innenseite	Innenseiten
Innenstadt	Innenstädte
Innovation	Innovationen
Innung	Innungen
Inquisition	Inquisitionen
Inschrift	Inschriften
Insel	Inseln
Inselgruppe	Inselgruppen
Insolvenz	Insolvenzen
Inspektion	Inspektionen
Inspiration	Inspirationen
Installation	Installationen
Installierung	Installierungen
Instandhaltung	Instandhaltungen
Instandsetzung	Instandsetzungen
Instanz	Instanzen
Institution	Institutionen
Instruktion	Instruktionen
Instrumentalisierung	Instrumentalisierungen
Inszenierung	Inszenierungen
Integration	Integrationen
Intelligenz	Intelligenzen
Intendantin	Intendantinnen
Intendanz	Intendanzen
Intensität	Intensitäten
Intensivierung	Intensivierungen
Intensivstation	Intensivstationen
Intention	Intentionen
Interaktion	Interaktionen
Interessengemeinschaft	Interessengemeinschaften
Interessengruppe	Interessengruppen
Interessenvertretung	Interessenvertretungen
Internationalisierung	Internationalisierungen
Internetseite	Internetseiten
Interpellation	Interpellationen
Interpol	—
Interpretation	Interpretationen
Intervention	Interventionen
Intimität	Intimitäten
Intoleranz	Intoleranzen
Intonation	Intonationen
Intrige	Intrigen
Intuition	Intuitionen
Invasion	Invasionen
Investition	Investitionen
Investitionsbank	Investitionsbanken
Investitionssumme	Investitionssummen
Investmentbank	Investmentbanken
Investmentgesellschaft	Investmentgesellschaften
Investorengruppe	Investorengruppen
Ironie	Ironien
Irrfahrt	Irrfahrten
Irritation	Irritationen
Isar	—
Isolation	Isolationen
Isolierung	Isolierungen
Jacht	Jachten
Jacke	Jacken
Jagd	Jagden
Jahresbilanz	Jahresbilanzen
Jahresfrist	Jahresfristen
Jahreshauptversammlung	Jahreshauptversammlungen
Jahreskarte	Jahreskarten
Jahresmitte	Jahresmitten
Jahresrechnung	Jahresrechnungen
Jahrestagung	Jahrestagungen
Jahresversammlung	Jahresversammlungen
Jahreswende	Jahreswenden
Jahreszahl	Jahreszahlen
Jahreszeit	Jahreszeiten
Jahrgangsstufe	Jahrgangsstufen
Jahrhundertwende	Jahrhundertwenden
Jahrtausendwende	Jahrtausendwenden
Jalousie	Jalousien
Japanerin	Japanerinnen
Jause	Jausen
Jobsuche	—
Journalistin	Journalistinnen
Jubilarin	Jubilarinnen
Judenverfolgung	Judenverfolgungen
Jugend	—
Jugendabteilung	Jugendabteilungen
Jugendarbeit	Jugendarbeiten
Jugendarbeitslosigkeit	—
Jugendbande	Jugendbanden
Jugendfeuerwehr	Jugendfeuerwehren
Jugendgruppe	Jugendgruppen
Jugendherberge	Jugendherbergen
Jugendhilfe	Jugendhilfen
Jugendkultur	Jugendkulturen
Jugendmannschaft	Jugendmannschaften
Jugendmusik	—
Jugendmusikschule	Jugendmusikschulen
Jugendorganisation	Jugendorganisationen
Jugendstrafe	Jugendstrafen
Jugendzeit	Jugendzeiten
Jungfrau	Jungfraus
Jungschar	Jungscharen
Juniorin	Juniorinnen
Junta	Junten
Juristin	Juristinnen
Jury	Jurys
Justiz	—
Justizanstalt	Justizanstalten
Justizministerin	Justizministerinnen
Justizsenatorin	Justizsenatorinnen
Justizsprecherin	Justizsprecherinnen
Justizvollzugsanstalt	Justizvollzugsanstalten
Kabine	Kabinen
Kabinettssitzung	Kabinettssitzungen
Kabinettsumbildung	Kabinettsumbildungen
Kachel	Kacheln
Kacke	Kacken
Kaffeemaschine	Kaffeemaschinen
Kaiserin	Kaiserinnen
Kajüte	Kajüten
Kalaschnikow	Kalaschnikows
Kalkulation	Kalkulationen
Kalle	Kallen
Kalorie	Kalorien
Kamera	Kameras
Kameradschaft	Kameradschaften
Kammer	Kammern
Kammermusik	—
Kammeroper	Kammeropern
Kampagne	Kampagnen
Kampfabstimmung	Kampfabstimmungen
Kampfansage	Kampfansagen
Kampfhandlung	Kampfhandlungen
Kampfkraft	Kampfkräfte
Kanadierin	Kanadierinnen
Kanalisation	Kanalisationen
Kandidatenliste	Kandidatenlisten
Kandidatin	Kandidatinnen
Kandidatur	Kandidaturen
Kanne	Kannen
Kanone	Kanonen
Kante	Kanten
Kantine	Kantinen
Kantonalbank	Kantonalbanken
Kantonspolizei	Kantonspolizeien
Kantonsregierung	Kantonsregierungen
Kantonsschule	Kantonsschulen
Kanzel	Kanzeln
Kanzlei	Kanzleis
Kanzlerin	Kanzlerinnen
Kanzlerkandidatur	Kanzlerkandidaturen
Kanzlerschaft	Kanzlerschaften
Kapazität	Kapazitäten
Kapelle	Kapellen
Kapitalanlage	Kapitalanlagen
Kapitalgesellschaft	Kapitalgesellschaften
Kapitulation	Kapitulationen
Kappe	Kappen
Kapriole	Kapriolen
Kapsel	Kapseln
Kapuze	Kapuzen
Karambolage	Karambolagen
Karawane	Karawanen
Karenz	Karenzen
Karibik	—
Karikatur	Karikaturen
Karosse	Karossen
Karosserie	Karosserien
Karotte	Karotten
Karre	Karren
Karriere	Karrieren
Karriereleiter	Karriereleitern
Karte	Karten
Kartei	Karteien
Kartoffel	Kartoffeln
Kaserne	Kasernen
Kassa	Kassen
Kasse	Kassen
Kassette	Kassetten
Kassiererin	Kassiererinnen
Kassierin	Kassierinnen
Kastanie	Kastanien
Kastanienallee	Kastanienalleen
Kaste	Kasten
Katakombe	Katakomben
Katastrophe	Katastrophen
Kate	Katen
Kategorie	Kategorien
Kathedrale	Kathedralen
Katze	Katzen
Kaufkraft	Kaufkräfte
Kaution	Kautionen
Kavallerie	Kavallerien
Kehle	Kehlen
Kehre	Kehren
Kehrseite	Kehrseiten
Kehrtwendung	Kehrtwendungen
Keimzelle	Keimzellen
Kelle	Kellen
Kellnerin	Kellnerinnen
Kenntnis	Kenntnisse
Kennzahl	Kennzahlen
Kennzeichnung	Kennzeichnungen
Keramik	Keramiken
Kerbe	Kerben
Kernenergie	Kernenergien
Kernfrage	Kernfragen
Kernkompetenz	Kernkompetenzen
Kernkraft	Kernkräfte
Kernstadt	Kernstädte
Kernwaffe	Kernwaffen
Kerwe	Kerwen
Kerze	Kerzen
Kette	Ketten
Kettenreaktion	Kettenreaktionen
Kettensäge	Kettensägen
Keule	Keulen
Kilowattstunde	Kilowattstunden
Kinderarbeit	Kinderarbeiten
Kinderbetreuung	—
Kindererziehung	—
Kindergruppe	Kindergruppen
Kinderklinik	Kinderkliniken
Kinderkrankheit	Kinderkrankheiten
Kinderkrippe	Kinderkrippen
Kindheit	—
Kippe	Kippen
Kirche	Kirchen
Kirchengemeinde	Kirchengemeinden
Kirchenleitung	Kirchenleitungen
Kirchenmusik	Kirchenmusiken
Kirchensteuer	Kirchensteuern
Kirchgemeinde	Kirchgemeinden
Kirsche	Kirschen
Kiste	Kisten
Kita	Kitas
Klage	Klagen
Klammer	Klammern
Klamotte	Klamotten
Klangfarbe	Klangfarben
Klappe	Klappen
Klapsmühle	Klapsmühlen
Klarheit	Klarheiten
Klarinette	Klarinetten
Klarstellung	Klarstellungen
Klasse	Klassen
Klassenfahrt	Klassenfahrten
Klassik	—
Klatsche	Klatschen
Klauenseuche	Klauenseuchen
Klausel	Klauseln
Klausur	Klausuren
Klausurtagung	Klausurtagungen
Kleidung	Kleidungen
Kleinarbeit	—
Kleine	Kleinen
Kleingruppe	Kleingruppen
Kleinigkeit	Kleinigkeiten
Kleinkunst	Kleinkünste
Kleinstadt	Kleinstädte
Klemme	Klemmen
Kletterwand	Kletterwände
Klientel	Klientelen
Klimaanlage	Klimaanlagen
Klimakonferenz	Klimakonferenzen
Klinge	Klingen
Klingel	Klingeln
Klinik	Kliniken
Klinke	Klinken
Klippe	Klippen
Klosterkirche	Klosterkirchen
Klubobfrau	Klubobfrauen
Klugheit	Klugheiten
Knappheit	Knappheiten
Kneipe	Kneipen
Knesset	—
Knieverletzung	Knieverletzungen
Knospe	Knospen
Koalition	Koalitionen
Koalitionsaussage	Koalitionsaussagen
Koalitionsfraktion	Koalitionsfraktionen
Koalitionspartei	Koalitionsparteien
Koalitionsregierung	Koalitionsregierungen
Koalitionsrunde	Koalitionsrunden
Koalitionsvereinbarung	Koalitionsvereinbarungen
Koalitionsverhandlung	Koalitionsverhandlungen
Kochkunst	Kochkünste
Koexistenz	—
Kohle	Kohlen
Kollaboration	Kollaborationen
Kollegin	Kolleginnen
Kollekte	Kollekten
Kollektion	Kollektionen
Kollision	Kollisionen
Kolonialmacht	Kolonialmächte
Kolonialzeit	Kolonialzeiten
Kolonie	Kolonien
Kolonne	Kolonnen
Kolumne	Kolumnen
Kombination	Kombinationen
Komik	—
Kommerzialisierung	Kommerzialisierungen
Kommissarin	Kommissarinnen
Kommission	Kommissionen
Kommode	Kommoden
Kommunalpolitik	Kommunalpolitiken
Kommunalwahl	Kommunalwahlen
Kommune	Kommunen
Kommunikation	Kommunikationen
Kommunikationstechnik	Kommunikationstechniken
Kommunikationstechnologie	Kommunikationstechnologien
Kommunion	Kommunionen
Kompanie	Kompanien
Kompensation	Kompensationen
Kompetenz	Kompetenzen
Komplexität	Komplexitäten
Komplikation	Komplikationen
Komponente	Komponenten
Komponistin	Komponistinnen
Komposition	Kompositionen
Kompromissbereitschaft	Kompromissbereitschaften
Komödie	Komödien
Kondition	Konditionen
Konditorei	Konditoreis
Konferenz	Konferenzen
Konfession	Konfessionen
Konfiguration	Konfigurationen
Konfliktpartei	Konfliktparteien
Konfrontation	Konfrontationen
Konfusion	Konfusionen
Konföderation	Konföderationen
Kongresshalle	Kongresshallen
Konjunktur	Konjunkturen
Konjunkturflaute	Konjunkturflauten
Konkurrentin	Konkurrentinnen
Konkurrenz	Konkurrenzen
Konkursmasse	Konkursmassen
Konsequenz	Konsequenzen
Konserve	Konserven
Konsistenz	Konsistenzen
Konsole	Konsolen
Konsolidierung	Konsolidierungen
Konstante	Konstanten
Konstellation	Konstellationen
Konstitution	Konstitutionen
Konstruktion	Konstruktionen
Konsultation	Konsultationen
Kontaktadresse	Kontaktadressen
Kontaktaufnahme	Kontaktaufnahmen
Kontaktgruppe	Kontaktgruppen
Kontaktlinse	Kontaktlinsen
Kontonummer	Kontonummern
Kontrolle	Kontrollen
Kontrollstelle	Kontrollstellen
Kontroverse	Kontroversen
Konvention	Konventionen
Konvergenz	Konvergenzen
Konversation	Konversationen
Konversion	Konversionen
Konzentration	Konzentrationen
Konzeption	Konzeptionen
Konzernleitung	Konzernleitungen
Konzernspitze	Konzernspitzen
Konzernzentrale	Konzernzentralen
Konzertreihe	Konzertreihen
Konzession	Konzessionen
Kooperation	Kooperationen
Koordinate	Koordinaten
Koordination	Koordinationen
Koordinierung	Koordinierungen
Kopfbedeckung	Kopfbedeckungen
Kopfpauschale	Kopfpauschalen
Kopfverletzung	Kopfverletzungen
Kopie	Kopien
Koppelung	Koppelungen
Kopplung	Kopplungen
Koproduktion	Koproduktionen
Koralle	Korallen
Korrektheit	Korrektheiten
Korrektur	Korrekturen
Korrespondentin	Korrespondentinnen
Korrespondenz	Korrespondenzen
Korruption	Korruptionen
Kosmetik	Kosmetika
Kost	—
Kostbarkeit	Kostbarkeiten
Kosten	—
Kosteneinsparung	Kosteneinsparungen
Kostenexplosion	Kostenexplosionen
Kostensenkung	Kostensenkungen
Kostensteigerung	Kostensteigerungen
Kostenstruktur	Kostenstrukturen
Kostprobe	Kostproben
Krabbe	Krabben
Kraft	Kräfte
Kraftprobe	Kraftproben
Kralle	Krallen
Kranke	Kranken
Krankenanstalt	Krankenanstalten
Krankenkasse	Krankenkassen
Krankenpflege	—
Krankenschwester	Krankenschwestern
Krankenstation	Krankenstationen
Krankenversicherung	Krankenversicherungen
Krankheit	Krankheiten
Krause	Krausen
Krawatte	Krawatten
Kreation	Kreationen
Kreatur	Kreaturen
Krebserkrankung	Krebserkrankungen
Krebszelle	Krebszellen
Kreditanstalt	Kreditanstalten
Kreditaufnahme	Kreditaufnahmen
Kreditkarte	Kreditkarten
Kreditvergabe	Kreditvergaben
Kreditwirtschaft	—
Kreide	Kreiden
Kreisklasse	Kreisklassen
Kreisliga	Kreisligen
Kreisstadt	Kreisstädte
Kreisverwaltung	Kreisverwaltungen
Kreuzfahrt	Kreuzfahrten
Kreuzung	Kreuzungen
Krida	—
Kriegsgefangenschaft	Kriegsgefangenschaften
Kriegspartei	Kriegsparteien
Kriegszeit	Kriegszeiten
Krim	—
Kriminalisierung	Kriminalisierungen
Kriminalpolizei	Kriminalpolizeien
Kriminalstatistik	Kriminalstatistiken
Kripo	Kripos
Krippe	Krippen
Krise	Krisen
Krisenregion	Krisenregionen
Krisensituation	Krisensituationen
Krisensitzung	Krisensitzungen
Krisenzeit	Krisenzeiten
Krisis	Krisen
Kritik	Kritiken
Kritikerin	Kritikerinnen
Kroatin	Kroatinnen
Krone	Kronen
Kronkolonie	Kronkolonien
Kronzeugenregelung	Kronzeugenregelungen
Krähe	Krähen
Krönung	Krönungen
Kröte	Kröten
Krücke	Krücken
Kugel	Kugeln
Kuh	Kühe
Kulisse	Kulissen
Kultfigur	Kultfiguren
Kultur	Kulturen
Kulturarbeit	Kulturarbeiten
Kultureinrichtung	Kultureinrichtungen
Kulturgeschichte	Kulturgeschichten
Kulturhauptstadt	Kulturhauptstädte
Kulturlandschaft	Kulturlandschaften
Kulturpolitik	Kulturpolitiken
Kulturrevolution	Kulturrevolutionen
Kultursenatorin	Kultursenatorinnen
Kulturszene	Kulturszenen
Kulturveranstaltung	Kulturveranstaltungen
Kulturwissenschaft	Kulturwissenschaften
Kultusgemeinde	Kultusgemeinden
Kultusministerin	Kultusministerinnen
Kultusministerkonferenz	—
Kundgebung	Kundgebungen
Kundin	Kundinnen
Kundschaft	Kundschaften
Kunkel	Kunkeln
Kunst	Künste
Kunstakademie	Kunstakademien
Kunstausstellung	Kunstausstellungen
Kunsteisbahn	Kunsteisbahnen
Kunstform	Kunstformen
Kunstgeschichte	Kunstgeschichten
Kunsthalle	Kunsthallen
Kunsthistorikerin	Kunsthistorikerinnen
Kunsthochschule	Kunsthochschulen
Kunstmesse	Kunstmessen
Kunstsammlung	Kunstsammlungen
Kunstszene	Kunstszenen
Kunstwelt	—
Kuppel	Kuppeln
Kupplung	Kupplungen
Kuratorin	Kuratorinnen
Kurdin	Kurdinnen
Kursentwicklung	Kursentwicklungen
Kurskorrektur	Kurskorrekturen
Kursleiterin	Kursleiterinnen
Kurssteigerung	Kurssteigerungen
Kurstadt	Kurstädte
Kurve	Kurven
Kurzarbeit	Kurzarbeiten
Kurzgeschichte	Kurzgeschichten
Kurzparkzone	Kurzparkzonen
Kurzweil	—
Kusine	Kusinen
Kutsche	Kutschen
Königin	Königinnen
Königsfamilie	Königsfamilien
Körperverletzung	Körperverletzungen
Küche	Küchen
Kündigung	Kündigungen
Küstenwache	Küstenwachen
Ladenschlusszeit	Ladenschlusszeiten
Ladung	Ladungen
Lady	Ladys
Lage	Lagen
Lagerhalle	Lagerhallen
Lagerung	Lagerungen
Lagune	Lagunen
Lake	Laken
Landebahn	Landebahnen
Landesanstalt	Landesanstalten
Landesbank	Landesbanken
Landesbibliothek	Landesbibliotheken
Landesebene	Landesebenen
Landesgartenschau	Landesgartenschauen
Landesgrenze	Landesgrenzen
Landesgruppe	Landesgruppen
Landeshauptstadt	Landeshauptstädte
Landeskirche	Landeskirchen
Landesliga	Landesligen
Landesliste	Landeslisten
Landesmedienanstalt	Landesmedienanstalten
Landesmeisterschaft	Landesmeisterschaften
Landespartei	Landesparteien
Landespolitik	Landespolitiken
Landesregierung	Landesregierungen
Landessprache	Landessprachen
Landesverteidigung	Landesverteidigungen
Landeszentralbank	Landeszentralbanken
Landeszentrale	Landeszentralen
Landfrau	Landfrauen
Landgemeinde	Landgemeinden
Landjugend	—
Landkarte	Landkarten
Landmine	Landminen
Landschaft	Landschaften
Landschaftspflege	Landschaftspflegen
Landsgemeinde	Landsgemeinden
Landsmannschaft	Landsmannschaften
Landtagsfraktion	Landtagsfraktionen
Landtagssitzung	Landtagssitzungen
Landtagswahl	Landtagswahlen
Landung	Landungen
Landwirtschaft	Landwirtschaften
Landwirtschaftskammer	Landwirtschaftskammern
Langeweile	Langeweilen
Langsamkeit	—
Langstrecke	Langstrecken
Lanze	Lanzen
Larve	Larven
Last	Lasten
Laterne	Laternen
Latte	Latten
Lauda	Laude
Laudatio	Laudationes	Laudationen
Laufbahn	Laufbahnen
Laufzeit	Laufzeiten
Laune	Launen
Laus	Läuse
Laute	Lauten
Lautstärke	Lautstärken
Lava	Lavas
Lawine	Lawinen
Lawinengefahr	Lawinengefahren
Lebendigkeit	Lebendigkeiten
Lebensart	Lebensarten
Lebensbedingung	Lebensbedingungen
Lebensdauer	Lebensdauern
Lebenserfahrung	Lebenserfahrungen
Lebenserwartung	—
Lebensform	Lebensformen
Lebensfreude	—
Lebensgefahr	Lebensgefahren
Lebensgemeinschaft	Lebensgemeinschaften
Lebensgeschichte	Lebensgeschichten
Lebensgrundlage	Lebensgrundlagen
Lebenshilfe	Lebenshilfen
Lebenslage	Lebenslagen
Lebenslust	—
Lebensphase	Lebensphasen
Lebensplanung	Lebensplanungen
Lebensqualität	Lebensqualitäten
Lebenssituation	Lebenssituationen
Lebensversicherung	Lebensversicherungen
Lebensweise	Lebensweisen
Lebenswelt	Lebenswelten
Lebenszeit	Lebenszeiten
Leber	Lebern
Leckerei	Leckereien
Lederhose	Lederhosen
Lederjacke	Lederjacken
Lee	—
Leere	—
Leerstelle	Leerstellen
Legalisierung	Legalisierungen
Legende	Legenden
Legion	Legionen
Legislative	Legislativen
Legislaturperiode	Legislaturperioden
Legitimation	Legitimationen
Lehne	Lehnen
Lehranstalt	Lehranstalten
Lehrerausbildung	Lehrerausbildungen
Lehrerin	Lehrerinnen
Lehrerschaft	Lehrerschaften
Lehrerstelle	Lehrerstellen
Lehrkraft	Lehrkräfte
Lehrlingsausbildung	Lehrlingsausbildungen
Lehrstelle	Lehrstellen
Lehrstunde	Lehrstunden
Lehrveranstaltung	Lehrveranstaltungen
Lehrzeit	Lehrzeiten
Leiche	Leichen
Leichenhalle	Leichenhallen
Leichtathletik	—
Leichtigkeit	Leichtigkeiten
Leidenschaft	Leidenschaften
Leidensgeschichte	Leidensgeschichten
Leihgabe	Leihgaben
Leinwand	Leinwände
Leistung	Leistungen
Leistungsbilanz	Leistungsbilanzen
Leistungsschau	Leistungsschauen
Leistungssteigerung	Leistungssteigerungen
Leiterin	Leiterinnen
Leitfigur	Leitfiguren
Leitkultur	Leitkulturen
Leitlinie	Leitlinien
Leitplanke	Leitplanken
Leitschiene	Leitschienen
Leitstelle	Leitstellen
Leitung	Leitungen
Lektion	Lektionen
Lektüre	Lektüren
Lenkerin	Lenkerinnen
Lenkung	Lenkungen
Lesart	Lesarten
Lese	Lesen
Leserschaft	Leserschaften
Lesung	Lesungen
Lethargie	—
Letter	Lettern
Leuchte	Leuchten
Lex	Lex
Liaison	Liaisons
Liberalisierung	Liberalisierungen
Liberation	Liberationen
Lichte	Lichtes	Lichte
Lichterkette	Lichterketten
Lichtgeschwindigkeit	Lichtgeschwindigkeiten
Lichtgestalt	Lichtgestalten
Lichtquelle	Lichtquellen
Lichtung	Lichtungen
Liebe	Lieben
Liebesbeziehung	Liebesbeziehungen
Liebesgeschichte	Liebesgeschichten
Liebschaft	Liebschaften
Lieferung	Lieferungen
Liegenschaft	Liegenschaften
Liga	Ligas
Lilie	Lilien
Limite	Limiten
Limonade	Limonaden
Limousine	Limousinen
Linde	Linden
Linderung	Linderungen
Linie	Linien
Linke	Linken
Linkskurve	Linkskurven
Linkspartei	Linksparteien
Linse	Linsen
Linzerin	Linzerinnen
Liquidation	Liquidationen
Liquidierung	Liquidierungen
List	Listen
Liste	Listen
Literatur	Literaturen
Literaturgeschichte	Literaturgeschichten
Literaturwissenschaft	Literaturwissenschaften
Liturgie	Liturgien
Lizenz	Lizenzen
Lobby	Lobbys
Lockerheit	Lockerheiten
Lockerung	Lockerungen
Lodge	Lodges
Loge	Logen
Logik	Logiken
Logistik	Logistiken
Lohnforderung	Lohnforderungen
Lohnfortzahlung	Lohnfortzahlungen
Lohnpolitik	Lohnpolitiken
Lohnrunde	Lohnrunden
Lohnsteuer	Lohnsteuern
Loipe	Loipen
Lok	Loks
Lokalbahn	Lokalbahnen
Lokalzeitung	Lokalzeitungen
Lokomotive	Lokomotiven
Lolita	Lolitas
Lombardei	—
Lotterie	Lotterien
Lounge	Lounges
Luft	Lüfte
Luftfahrt	—
Luftfeuchtigkeit	Luftfeuchtigkeiten
Lufthansa	—
Luftlinie	Luftlinien
Luftröhre	Luftröhren
Luftverschmutzung	Luftverschmutzungen
Luftwaffe	Luftwaffen
Luke	Luken
Lunge	Lungen
Lungenentzündung	Lungenentzündungen
Lupe	Lupen
Lust	Lüste
Lyrik	—
Lyrikerin	Lyrikerinnen
Lähmung	Lähmungen
Läuterung	Läuterungen
Lösung	Lösungen
Lücke	Lücken
Maas	—
Machart	Macharten
Machbarkeit	—
Machbarkeitsstudie	Machbarkeitsstudien
Mache	—
Machenschaft	Machenschaften
Macht	Mächte
Machtergreifung	Machtergreifungen
Machtposition	Machtpositionen
Madame	Madamen
Made	Maden
Madonna	Madonnen
Mafia	Mafias
Magd	Mägde
Magersucht	—
Magie	Magien
Magnum	Magna	Magnums
Mahlzeit	Mahlzeiten
Mahnung	Mahnungen
Mahnwache	Mahnwachen
Mailbox	Mailboxen
Makulatur	Makulaturen
Malaria	—
Malerei	Malereien
Malerin	Malerinnen
Mama	Mamas
Mami	Mamis
Mamma	Mammae
Managerin	Managerinnen
Mandantin	Mandantinnen
Manege	Manegen
Mangelware	Mangelwaren
Manier	Manieren
Manifestation	Manifestationen
Maniküre	Maniküren
Manipulation	Manipulationen
Mannschaft	Mannschaften
Mannschaftsleistung	Mannschaftsleistungen
Mannschaftsmeisterschaft	Mannschaftsmeisterschaften
Mannschaftswertung	Mannschaftswertungen
Manufaktur	Manufakturen
Mappe	Mappen
Mara	Maras
Marge	Margen
Marienkirche	Marienkirchen
Marine	Marinen
Marionette	Marionetten
Marke	Marken
Markierung	Markierungen
Marktchance	Marktchancen
Marktforschung	Marktforschungen
Marktgemeinde	Marktgemeinden
Markthalle	Markthallen
Marktkapitalisierung	Marktkapitalisierungen
Marktmacht	Marktmächte
Marktposition	Marktpositionen
Marktwirtschaft	Marktwirtschaften
Marmelade	Marmeladen
Marsch	Marschen
Marschrichtung	Marschrichtungen
Marschroute	Marschrouten
Masche	Maschen
Maschine	Maschinen
Maschinenfabrik	Maschinenfabriken
Maschinenpistole	Maschinenpistolen
Maschinerie	Maschinerien
Maske	Masken
Massage	Massagen
Masse	Massen
Massenarbeitslosigkeit	—
Massenentlassung	Massenentlassungen
Massenflucht	Massenfluchten
Massenproduktion	Massenproduktionen
Massenvernichtungswaffe	Massenvernichtungswaffen
Materie	Materien
Mathe	—
Mathematik	—
Matinee	Matineen
Matratze	Matratzen
Matrix	Matrizen	Matrizes	Matrices
Mattscheibe	Mattscheiben
Matura	Maturen
Mauer	Mauern
Maus	Mäuse
Maut	Mauten
Maxime	Maximen
Mayonnaise	Mayonnaisen
Maß	Maße
Maßnahme	Maßnahmen
Mechanik	Mechaniken
Medaille	Medaillen
Mediation	Mediationen
Medienanstalt	Medienanstalten
Medienlandschaft	Medienlandschaften
Medienpolitik	—
Medienwelt	—
Meditation	Meditationen
Medizin	Medizinnen
Medizinerin	Medizinerinnen
Medizintechnik	Medizintechniken
Mehrarbeit	Mehrarbeiten
Mehrausgabe	Mehrausgaben
Mehrbelastung	Mehrbelastungen
Mehreinnahme	Mehreinnahmen
Mehrheit	Mehrheiten
Mehrheitsbeteiligung	Mehrheitsbeteiligungen
Mehrheitsentscheidung	Mehrheitsentscheidungen
Mehrwertsteuer	Mehrwertsteuern
Mehrzahl	Mehrzahlen
Mehrzweckhalle	Mehrzweckhallen
Meile	Meilen
Meinung	Meinungen
Meinungsbildung	Meinungsbildungen
Meinungsfreiheit	Meinungsfreiheiten
Meinungsumfrage	Meinungsumfragen
Meinungsverschiedenheit	Meinungsverschiedenheiten
Meisterin	Meisterinnen
Meisterklasse	Meisterklassen
Meisterleistung	Meisterleistungen
Meisterschaft	Meisterschaften
Melancholie	Melancholien
Melange	Melangen
Meldepflicht	Meldepflichten
Meldung	Meldungen
Melodie	Melodien
Melone	Melonen
Membran	Membranen
Menge	Mengen
Meningitis	Meningitiden
Mensa	Mensen	Mensas
Menschenmasse	Menschenmassen
Menschenmenge	Menschenmengen
Menschenrechtsgruppe	Menschenrechtsgruppen
Menschenrechtskommission	Menschenrechtskommissionen
Menschenrechtsorganisation	Menschenrechtsorganisationen
Menschenrechtsverletzung	Menschenrechtsverletzungen
Menschheit	—
Menschheitsgeschichte	—
Menschlichkeit	Menschlichkeiten
Mentalität	Mentalitäten
Message	Messages
Messehalle	Messehallen
Messerstecherei	Messerstechereien
Messestadt	Messestädte
Messlatte	Messlatten
Messung	Messungen
Metallindustrie	Metallindustrien
Metamorphose	Metamorphosen
Metapher	Metaphern
Metaphysik	—
Meteorologie	—
Methode	Methoden
Methodik	Methodiken
Metro	Metros
Metropole	Metropolen
Metropolis	Metropolen
Metropolregion	Metropolregionen
Metzgerei	Metzgereis
Meute	Meuten
Meuterei	Meutereis
Miene	Mienen
Mieteinnahme	Mieteinnahmen
Mieterin	Mieterinnen
Mietwohnung	Mietwohnungen
Migration	Migrationen
Migräne	Migränen
Mikroelektronik	Mikroelektroniken
Mikrowelle	Mikrowellen
Milch	Milche
Milde	—
Militärpolizei	Militärpolizeis
Miliz	Milizen
Milliarde	Milliarden
Million	Millionen
Millionenstadt	Millionenstädte
Milz	Milzen
Mimi	Mimis
Mimik	—
Mindereinnahme	Mindereinnahmen
Minderheit	Minderheiten
Minderheitsbeteiligung	Minderheitsbeteiligungen
Minderheitsregierung	Minderheitsregierungen
Minderung	Minderungen
Miniatur	Miniaturen
Ministerin	Ministerinnen
Minute	Minuten
Mischung	Mischungen
Misere	Miseren
Miss	Misses	Missen
Missa	Missae
Missachtung	Missachtungen
Missgunst	—
Misshandlung	Misshandlungen
Mission	Missionen
Misswirtschaft	—
Mitarbeit	—
Mitarbeiterin	Mitarbeiterinnen
Mitarbeiterzahl	Mitarbeiterzahlen
Mitbestimmung	Mitbestimmungen
Mitgift	Mitgiften
Mitgliederversammlung	Mitgliederversammlungen
Mitgliederzahl	Mitgliederzahlen
Mitgliedschaft	Mitgliedschaften
Mithilfe	Mithilfen
Mitleidenschaft	—
Mitschuld	—
Mittagspause	Mittagspausen
Mittagszeit	—
Mitte	Mitten
Mitteilung	Mitteilungen
Mittelhand	Mittelhände
Mittelklasse	Mittelklassen
Mittellinie	Mittellinien
Mittelmeerinsel	Mittelmeerinseln
Mittelschicht	Mittelschichten
Mittelschule	Mittelschulen
Mittelstufe	Mittelstufen
Mitternacht	Mitternächte
Mitverantwortung	Mitverantwortungen
Mitwirkung	Mitwirkungen
Mixtur	Mixturen
Mobilisierung	Mobilisierungen
Mode	Moden
Modenschau	Modenschaus
Moderation	Moderationen
Moderatorin	Moderatorinnen
Moderne	—
Modernisierung	Modernisierungen
Modeschau	Modeschauen
Modifikation	Modifikationen
Mogelpackung	Mogelpackungen
Molkerei	Molkereien
Momentaufnahme	Momentaufnahmen
Monarchie	Monarchien
Monatskarte	Monatskarten
Mongolei	—
Monokultur	Monokulturen
Monopolstellung	Monopolstellungen
Monotonie	Monotonien
Montage	Montagen
Moral	Moralen
Morddrohung	Morddrohungen
Mordkommission	Mordkommissionen
Mordwaffe	Mordwaffen
More	Moren
Morgendämmerung	Morgendämmerungen
Morgenpost	Morgenposten
Morgenstunde	Morgenstunden
Moschee	Moscheen
Motion	Motionen
Motivation	Motivationen
Motorhaube	Motorhauben
Motorisierung	Motorisierungen
Motte	Motten
Mulde	Mulden
Mumie	Mumien
Mundart	Mundarten
Mundharmonika	Mundharmonikas
Munition	Munitionen
Mure	Muren
Muschel	Muscheln
Muse	Musen
Musik	Musiken
Musikantin	Musikantinnen
Musikerin	Musikerinnen
Musikgeschichte	Musikgeschichten
Musikgruppe	Musikgruppen
Musikhochschule	Musikhochschulen
Musikindustrie	Musikindustrien
Musikkapelle	Musikkapellen
Musikschule	Musikschulen
Musikszene	Musikszenen
Muskulatur	Muskulaturen
Mutation	Mutationen
Mutprobe	Mutproben
Mutter	Mütter
Muttergesellschaft	Muttergesellschaften
Muttermilch	—
Muttersprache	Muttersprachen
Mutti	Muttis
Mystik	—
Mythologie	Mythologien
Mätresse	Mätressen
Möbel	—
Möhre	Möhren
Möwe	Möwen
Mücke	Mücken
Müdigkeit	Müdigkeiten
Mühe	Mühen
Mühle	Mühlen
Müllabfuhr	Müllabfuhren
Müllhalde	Müllhalden
Mündung	Mündungen
Münze	Münzen
Mütze	Mützen
Nachahmung	Nachahmungen
Nachbargemeinde	Nachbargemeinden
Nachbarin	Nachbarinnen
Nachbarschaft	Nachbarschaften
Nachbarschaftshilfe	Nachbarschaftshilfen
Nachbarstadt	Nachbarstädte
Nachbesserung	Nachbesserungen
Nachbildung	Nachbildungen
Nachdenklichkeit	Nachdenklichkeiten
Nachfolge	Nachfolgen
Nachfolgerin	Nachfolgerinnen
Nachforschung	Nachforschungen
Nachfrage	Nachfragen
Nachhaltigkeit	—
Nachhilfe	Nachhilfen
Nachkriegsgeschichte	Nachkriegsgeschichten
Nachkriegszeit	Nachkriegszeiten
Nachrede	Nachreden
Nachricht	Nachrichten
Nachrichtenagentur	Nachrichtenagenturen
Nachrichtensendung	Nachrichtensendungen
Nachsicht	—
Nachspielzeit	Nachspielzeiten
Nacht	Nächte
Nachtarbeit	Nachtarbeiten
Nachtigall	Nachtigallen
Nachtruhe	—
Nachtschicht	Nachtschichten
Nachtstunde	Nachtstunden
Nachwahl	Nachwahlen
Nachwelt	—
Nachwirkung	Nachwirkungen
Nachwuchsarbeit	Nachwuchsarbeiten
Nachwuchskraft	Nachwuchskräfte
Nachzahlung	Nachzahlungen
Nacktheit	Nacktheiten
Nadel	Nadeln
Nagelprobe	Nagelproben
Nahaufnahme	Nahaufnahmen
Nahrung	Nahrungen
Naht	Nähte
Nahversorgung	—
Naivität	Naivitäten
Namensgebung	Namensgebungen
Namensliste	Namenslisten
Narbe	Narben
Narkose	Narkosen
Nase	Nasen
Nation	Nationen
Nationalbank	Nationalbanken
Nationalbibliothek	Nationalbibliotheken
Nationalelf	Nationalelfen
Nationalgalerie	Nationalgalerien
Nationalgarde	Nationalgarden
Nationalhymne	Nationalhymnen
Nationalität	Nationalitäten
Nationalliga	Nationalligen
Nationalmannschaft	Nationalmannschaften
Nationalspielerin	Nationalspielerinnen
Nationalversammlung	Nationalversammlungen
Natur	Naturen
Naturgewalt	Naturgewalten
Naturkatastrophe	Naturkatastrophen
Naturwissenschaft	Naturwissenschaften
Navigation	Navigationen
Nazizeit	—
Nebenrolle	Nebenrollen
Nebensache	Nebensachen
Nebenwirkung	Nebenwirkungen
Neige	Neigen
Neigung	Neigungen
Nelke	Nelken
Nennung	Nennungen
Nervensäge	Nervensägen
Nervenzelle	Nervenzellen
Nervosität	Nervositäten
Netzhaut	Netzhäute
Neuauflage	Neuauflagen
Neuausrichtung	Neuausrichtungen
Neubaustrecke	Neubaustrecken
Neubesetzung	Neubesetzungen
Neubewertung	Neubewertungen
Neueinstellung	Neueinstellungen
Neuemission	Neuemissionen
Neuentwicklung	Neuentwicklungen
Neuerscheinung	Neuerscheinungen
Neuerung	Neuerungen
Neuerwerbung	Neuerwerbungen
Neufassung	Neufassungen
Neugestaltung	Neugestaltungen
Neugier	—
Neugierde	—
Neuheit	Neuheiten
Neuigkeit	Neuigkeiten
Neuinszenierung	Neuinszenierungen
Neun	Neunen	Neuner
Neuordnung	Neuordnungen
Neuorganisation	Neuorganisationen
Neuorientierung	Neuorientierungen
Neuregelung	Neuregelungen
Neurologie	—
Neurose	Neurosen
Neustadt	Neustädte
Neustrukturierung	Neustrukturierungen
Neuverhandlung	Neuverhandlungen
Neuverpflichtung	Neuverpflichtungen
Neuverschuldung	Neuverschuldungen
Neuwahl	Neuwahlen
Neuzeit	—
Neuzulassung	Neuzulassungen
Nichte	Nichten
Nichtregierungsorganisation	Nichtregierungsorganisationen
Niederlage	Niederlagen
Niederlassung	Niederlassungen
Niederschlagung	Niederschlagungen
Niederschrift	Niederschriften
Niederung	Niederungen
Niere	Nieren
Niete	Nieten
Nische	Nischen
Nomenklatura	—
Nomination	Nominationen
Nominierung	Nominierungen
Nonne	Nonnen
Nordsee	—
Nordseite	Nordseiten
Norm	Normen
Normale	Normalen
Normalisierung	Normalisierungen
Normalität	Normalitäten
Normandie	—
Nostalgie	Nostalgien
Not	Nöte
Notaufnahme	Notaufnahmen
Notbremse	Notbremsen
Note	Noten
Notenbank	Notenbanken
Nothilfe	Nothilfen
Notierung	Notierungen
Notiz	Notizen
Notlage	Notlagen
Notlandung	Notlandungen
Notoperation	Notoperationen
Notsituation	Notsituationen
Notunterkunft	Notunterkünfte
Notwehr	—
Notwendigkeit	Notwendigkeiten
Novelle	Novellen
Novellierung	Novellierungen
Nuance	Nuancen
Nudel	Nudeln
Nuklearwaffe	Nuklearwaffen
Null	Nullen
Nullnummer	Nullnummern
Nullrunde	Nullrunden
Nummer	Nummern
Nuss	Nüsse
Nutte	Nutten
Nutzung	Nutzungen
Nächstenliebe	Nächstenlieben
Nähe	Nähen
Näherin	Näherinnen
Oase	Oasen
Obdachlosigkeit	Obdachlosigkeiten
Obduktion	Obduktionen
Obergrenze	Obergrenzen
Oberhand	—
Oberin	Oberinnen
Oberklasse	Oberklassen
Oberleitung	Oberleitungen
Oberliga	Oberligen
Oberpfalz	—
Oberschicht	Oberschichten
Oberschule	Oberschulen
Oberstufe	Oberstufen
Obfrau	Obfrauen
Obhut	—
Obligation	Obligationen
Oboe	Oboen
Obrigkeit	Obrigkeiten
Obsession	Obsessionen
Ode	Oden
Oder	Oders
Odyssee	Odysseen
Offenbarung	Offenbarungen
Offenheit	Offenheiten
Offenlegung	Offenlegungen
Offensive	Offensiven
Offerte	Offerten
Ohnmacht	Ohnmachten
Ohrfeige	Ohrfeigen
Okkupation	Okkupationen
Oktoberrevolution	—
Olive	Oliven
Olympiabewerbung	Olympiabewerbungen
Olympiade	Olympiaden
Olympiahalle	—
Olympiasiegerin	Olympiasiegerinnen
Olympiastadt	Olympiastädte
Oma	Omas
Oper	Opern
Operation	Operationen
Operette	Operetten
Opposition	Oppositionen
Oppositionsgruppe	Oppositionsgruppen
Oppositionspartei	Oppositionsparteien
Optik	Optiken
Optimierung	Optimierungen
Option	Optionen
Orange	Orangen
Orangerie	Orangerien
Orchestra	Orchestren
Orchidee	Orchideen
Order	Orders	Ordern
Ordination	Ordinationen
Ordnung	Ordnungen
Ordnungskraft	Ordnungskräfte
Ordnungswidrigkeit	Ordnungswidrigkeiten
Organisation	Organisationen
Organisationsform	Organisationsformen
Organisationsstruktur	Organisationsstrukturen
Organisatorin	Organisatorinnen
Organspende	Organspenden
Orgel	Orgeln
Orgie	Orgien
Orientierung	Orientierungen
Orientierungshilfe	Orientierungshilfen
Orientierungslosigkeit	—
Originalfassung	Originalfassungen
Orthodoxie	—
Ortschaft	Ortschaften
Ortsdurchfahrt	Ortsdurchfahrten
Ortsgemeinde	Ortsgemeinden
Ortsgruppe	Ortsgruppen
Ortsumgehung	Ortsumgehungen
Ortszeit	Ortszeiten
Osteoporose	Osteoporosen
Osterweiterung	Osterweiterungen
Ostgrenze	Ostgrenzen
Ostküste	Ostküsten
Ostpolitik	Ostpolitiken
Ostschweiz	—
Ostsee	—
Ostseite	Ostseiten
Ouvertüre	Ouvertüren
Ovation	Ovationen
Ozonschicht	—
Paarung	Paarungen
Pacht	Pachten
Packung	Packungen
Pak	Pak	Paks
Pale	Palen
Palette	Paletten
Palme	Palmen
Panik	Paniken
Panikmache	—
Papierfabrik	Papierfabriken
Papierindustrie	Papierindustrien
Pappe	Pappen
Pappel	Pappeln
Parabel	Parabeln
Parade	Paraden
Parallele	Parallelen
Paranoia	Paranoias
Parkanlage	Parkanlagen
Parkbank	Parkbänke
Parkraumbewirtschaftung	Parkraumbewirtschaftungen
Parlamentarierin	Parlamentarierinnen
Parlamentsdebatte	Parlamentsdebatten
Parlamentsmehrheit	Parlamentsmehrheiten
Parlamentssitzung	Parlamentssitzungen
Parlamentswahl	Parlamentswahlen
Parodie	Parodien
Partei	Parteis
Parteibasis	Parteibasen
Parteichefin	Parteichefinnen
Parteienfinanzierung	Parteienfinanzierungen
Parteinahme	Parteinahmen
Parteipolitik	Parteipolitiken
Parteispende	Parteispenden
Parteispitze	Parteispitzen
Parteizentrale	Parteizentralen
Partie	Partien
Partisane	Partisanen
Partitur	Partituren
Partnerin	Partnerinnen
Partnerschaft	Partnerschaften
Partnerstadt	Partnerstädte
Partnersuche	Partnersuchen
Party	Partys
Parzelle	Parzellen
Passage	Passagen
Passantin	Passantinnen
Passion	Passionen
Pasta	Pastas
Patenschaft	Patenschaften
Pathologie	Pathologien
Patientin	Patientinnen
Patrone	Patronen
Patrouille	Patrouillen
Patsche	Patschen
Patte	Patten
Pauke	Pauken
Pauschale	Pauschalen	Pauschale	Pauschalien
Pauschalreise	Pauschalreisen
Pause	Pausen
Peilung	Peilungen
Pein	Peinnen
Peinlichkeit	Peinlichkeiten
Peitsche	Peitschen
Pension	Pensionen
Pensionierung	Pensionierungen
Pensionistin	Pensionistinnen
Pensionskasse	Pensionskassen
Pensionsreform	Pensionsreformen
Pensionsversicherung	Pensionsversicherungen
Percussion	Percussions
Perestroika	—
Perfektion	Perfektionen
Performance	Performances
Periode	Perioden
Peripherie	Peripherien
Perle	Perlen
Persiflage	Persiflagen
Person	Personen
Personalabteilung	Personalabteilungen
Personalentscheidung	Personalentscheidungen
Personalfrage	Personalfragen
Personalie	Personalien
Personalpolitik	Personalpolitiken
Personalunion	Personalunionen
Personalvertretung	Personalvertretungen
Personengruppe	Personengruppen
Perspektive	Perspektiven
Perversion	Perversionen
Peseta	Peseten	Pesetas
Petersilie	Petersilien
Petition	Petitionen
Pfanne	Pfannen
Pfarre	Pfarren
Pfarrei	Pfarreien
Pfarrerin	Pfarrerinnen
Pfarrgemeinde	Pfarrgemeinden
Pfarrkirche	Pfarrkirchen
Pfeife	Pfeifen
Pflanze	Pflanzen
Pflanzenart	Pflanzenarten
Pflanzenwelt	Pflanzenwelten
Pflanzung	Pflanzungen
Pflege	—
Pflegekraft	Pflegekräfte
Pflegerin	Pflegerinnen
Pflegeversicherung	Pflegeversicherungen
Pflicht	Pflichten
Pflichtschule	Pflichtschulen
Pforte	Pforten
Pfote	Pfoten
Pfütze	Pfützen
Phalanx	Phalangen
Pharmafirma	Pharmafirmen
Pharmaindustrie	Pharmaindustrien
Phase	Phasen
Philharmonie	Philharmonien
Philologie	Philologien
Philosophie	Philosophien
Phrase	Phrasen
Phrasierung	Phrasierungen
Physik	—
Pianistin	Pianistinnen
Piazza	Piazzas	Piazze
Pille	Pillen
Pilote	Piloten
Pinakothek	Pinakotheken
Pionierarbeit	Pionierarbeiten
Pipa	Pipas
Pipeline	Pipelines
Pirouette	Pirouetten
Piste	Pisten
Pistole	Pistolen
Pizza	Pizzas
Pizzeria	Pizzerien	Pizzerias
Plage	Plagen
Plakatwand	Plakatwände
Plakette	Plaketten
Plane	Planen
Planke	Planken
Planstelle	Planstellen
Plantage	Plantagen
Planung	Planungen
Planungsphase	Planungsphasen
Planungssicherheit	Planungssicherheiten
Planwirtschaft	Planwirtschaften
Planänderung	Planänderungen
Plastik	Plastiken
Platane	Platanen
Platte	Platten
Plattenfirma	Plattenfirmen
Plattform	Plattformen
Platzierung	Platzierungen
Platzwunde	Platzwunden
Pleite	Pleiten
Plenarsitzung	Plenarsitzungen
Pocke	Pocken
Podiumsdiskussion	Podiumsdiskussionen
Poesie	Poesien
Poetik	Poetiken
Pointe	Pointen
Polarisierung	Polarisierungen
Polemik	Polemiken
Police	Policen
Poliklinik	Polikliniken
Polin	Polinnen
Politik	Politiken
Politikerin	Politikerinnen
Politikverdrossenheit	—
Politikwissenschaft	Politikwissenschaften
Politisierung	Politisierungen
Polizei	Polizeien
Polizeiaktion	Polizeiaktionen
Polizeiangabe	Polizeiangaben
Polizeidienststelle	Polizeidienststellen
Polizeidirektion	Polizeidirektionen
Polizeieinheit	Polizeieinheiten
Polizeigewerkschaft	Polizeigewerkschaften
Polizeiinspektion	Polizeiinspektionen
Polizeikontrolle	Polizeikontrollen
Polizeistreife	Polizeistreifen
Polizeiwache	Polizeiwachen
Polizistin	Polizistinnen
Polka	Polkas
Ponte	Ponten
Popkultur	Popkulturen
Popmusik	Popmusiken
Popularität	Popularitäten
Population	Populationen
Pore	Poren
Portion	Portionen
Posaune	Posaunen
Position	Positionen
Positionierung	Positionierungen
Posse	Possen
Post	Posten
Postbank	Postbanken
Postfiliale	Postfilialen
Postgewerkschaft	Postgewerkschaften
Postkarte	Postkarten
Postleitzahl	Postleitzahlen
Postmoderne	—
Poststelle	Poststellen
Potenz	Potenzen
Pracht	—
Praktik	Praktiken
Praktikantin	Praktikantinnen
Praxis	Praxen	Praktiken
Predigt	Predigten
Preisabsprache	Preisabsprachen
Preisbindung	Preisbindungen
Preisentwicklung	Preisentwicklungen
Preisgestaltung	Preisgestaltungen
Preisklasse	Preisklassen
Preisliste	Preislisten
Preispolitik	Preispolitiken
Preissenkung	Preissenkungen
Preisspanne	Preisspannen
Preissteigerung	Preissteigerungen
Preisverleihung	Preisverleihungen
Prellung	Prellungen
Premiere	Premieren
Premierministerin	Premierministerinnen
Presse	—
Presseagentur	Presseagenturen
Pressefreiheit	Pressefreiheiten
Pressekonferenz	Pressekonferenzen
Pressemitteilung	Pressemitteilungen
Pressesprecherin	Pressesprecherinnen
Pressestelle	Pressestellen
Pressestimme	Pressestimmen
Priesterweihe	Priesterweihen
Prim	Primen
Primarschule	Primarschulen
Prinzessin	Prinzessinnen
Priorität	Prioritäten
Prise	Prisen
Privatbank	Privatbanken
Privatfirma	Privatfirmen
Privatinitiative	Privatinitiativen
Privatisierung	Privatisierungen
Privatklinik	Privatkliniken
Privatperson	Privatpersonen
Privatsache	Privatsachen
Privatsammlung	Privatsammlungen
Privatschule	Privatschulen
Privatsphäre	Privatsphären
Privatwirtschaft	—
Privatwohnung	Privatwohnungen
Probe	Proben
Probefahrt	Probefahrten
Probezeit	Probezeiten
Problematik	Problematiken
Produktentwicklung	Produktentwicklungen
Produktion	Produktionen
Produktionsanlage	Produktionsanlagen
Produktionsfirma	Produktionsfirmen
Produktpalette	Produktpaletten
Profession	Professionen
Professionalisierung	Professionalisierungen
Professorin	Professorinnen
Professur	Professuren
Profilierung	Profilierungen
Profiliga	Profiligen
Prognose	Prognosen
Programmatik	Programmatiken
Programmiersprache	Programmiersprachen
Programmierung	Programmierungen
Projektarbeit	Projektarbeiten
Projektgruppe	Projektgruppen
Projektion	Projektionen
Projektleiterin	Projektleiterinnen
Projektwoche	Projektwochen
Promenade	Promenaden
Prominenz	Prominenzen
Propaganda	Propagandas
Prophezeiung	Prophezeiungen
Prophylaxe	Prophylaxen
Proportion	Proportionen
Prosa	—
Prostata	Prostatae
Prostituierte	Prostituierten
Prostitution	Prostitutionen
Protagonistin	Protagonistinnen
Protestaktion	Protestaktionen
Protestbewegung	Protestbewegungen
Protestkundgebung	Protestkundgebungen
Prothese	Prothesen
Provence	—
Provenienz	Provenienzen
Provinz	Provinzen
Provinzhauptstadt	Provinzhauptstädte
Provinzstadt	Provinzstädte
Provision	Provisionen
Provokation	Provokationen
Prozedur	Prozeduren
Prozession	Prozessionen
Prunksitzung	Prunksitzungen
Prämie	Prämien
Präsentation	Präsentationen
Präsenz	Präsenzen
Präsidentschaft	Präsidentschaften
Prügelei	Prügeleis
Psychiatrie	Psychiatrien
Psychoanalyse	Psychoanalysen
Psychologie	Psychologien
Psychologin	Psychologinnen
Psychose	Psychosen
Psychotherapeutin	Psychotherapeutinnen
Psychotherapie	Psychotherapien
Publicity	—
Publikation	Publikationen
Publizistik	—
Pufferzone	Pufferzonen
Pumpe	Pumpen
Punktzahl	Punktzahlen
Puppe	Puppen
Pussy	Pussys	Pussies
Puste	Pusten
Putzfrau	Putzfraus
Pyramide	Pyramiden
Pünktlichkeit	Pünktlichkeiten
Quadratur	Quadraturen
Qual	Qualen
Qualifikation	Qualifikationen
Qualifikationsrunde	Qualifikationsrunden
Qualifizierung	Qualifizierungen
Qualität	Qualitäten
Quarantäne	Quarantänen
Quartalszahl	Quartalszahlen
Quelle	Quellen
Quellensteuer	Quellensteuern
Quere	—
Querele	Querelen
Querverbindung	Querverbindungen
Quintessenz	Quintessenzen
Quittung	Quittungen
Quote	Quoten
Quotenregelung	Quotenregelungen
Rabatte	Rabatten
Rache	—
Radarkontrolle	Radarkontrollen
Radfahrerin	Radfahrerinnen
Radierung	Radierungen
Radikalisierung	Radikalisierungen
Radiosendung	Radiosendungen
Radiostation	Radiostationen
Radtour	Radtouren
Raffinerie	Raffinerien
Raffinesse	Raffinessen
Rage	—
Rahmenbedingung	Rahmenbedingungen
Rakete	Raketen
Raketenabwehr	—
Rallye	Rallyes
Rampe	Rampen
Ranch	Ranchs	Ranches
Randgruppe	Randgruppen
Rangelei	Rangeleien
Rangliste	Ranglisten
Raserei	Rasereien
Rasse	Rassen
Rast	Rasten
Rasterfahndung	Rasterfahndungen
Rate	Raten
Ratifizierung	Ratifizierungen
Ratio	—
Rationalisierung	Rationalisierungen
Ratlosigkeit	Ratlosigkeiten
Ratte	Ratten
Raubkopie	Raubkopien
Rauchentwicklung	Rauchentwicklungen
Rauchgasvergiftung	Rauchgasvergiftungen
Rauchvergiftung	Rauchvergiftungen
Rauchwolke	Rauchwolken
Rauferei	Raufereien
Raumfahrt	Raumfahrten
Raumordnung	Raumordnungen
Raumplanung	Raumplanungen
Raumsonde	Raumsonden
Raumstation	Raumstationen
Raupe	Raupen
Razzia	Razzias
Reaktion	Reaktionen
Realisierung	Realisierungen
Realität	Realitäten
Realpolitik	Realpolitiken
Realschule	Realschulen
Rebe	Reben
Rebellion	Rebellionen
Rebsorte	Rebsorten
Rechenschaft	—
Recherche	Recherchen
Rechnung	Rechnungen
Rechtfertigung	Rechtfertigungen
Rechtsabteilung	Rechtsabteilungen
Rechtsauffassung	Rechtsauffassungen
Rechtsberatung	Rechtsberatungen
Rechtsbeugung	Rechtsbeugungen
Rechtschreibreform	Rechtschreibreformen
Rechtschreibung	Rechtschreibungen
Rechtsform	Rechtsformen
Rechtsfrage	Rechtsfragen
Rechtsgrundlage	Rechtsgrundlagen
Rechtskurve	Rechtskurven
Rechtslage	Rechtslagen
Rechtsordnung	Rechtsordnungen
Rechtspartei	Rechtsparteien
Rechtsprechung	Rechtsprechungen
Rechtssicherheit	Rechtssicherheiten
Rechtsstaatlichkeit	—
Rechtsvorschrift	Rechtsvorschriften
Rechtswissenschaft	Rechtswissenschaften
Redakteurin	Redakteurinnen
Redaktion	Redaktionen
Rede	Reden
Redewendung	Redewendungen
Redezeit	Redezeiten
Reduktion	Reduktionen
Reduzierung	Reduzierungen
Reederei	Reedereien
Reeperbahn	Reeperbahnen
Referentin	Referentinnen
Referenz	Referenzen
Reflexion	Reflexionen
Reform	Reformen
Reformation	Reformationen
Reformpolitik	Reformpolitiken
Regatta	Regatten
Regel	Regeln
Regelung	Regelungen
Regeneration	Regenerationen
Regentschaft	Regentschaften
Regenzeit	Regenzeiten
Regie	Regien
Regierung	Regierungen
Regierungsarbeit	Regierungsarbeiten
Regierungsbank	Regierungsbanken
Regierungsbeteiligung	Regierungsbeteiligungen
Regierungsbildung	Regierungsbildungen
Regierungschefin	Regierungschefinnen
Regierungsfraktion	Regierungsfraktionen
Regierungskoalition	Regierungskoalitionen
Regierungskrise	Regierungskrisen
Regierungspartei	Regierungsparteien
Regierungspolitik	Regierungspolitiken
Regierungstruppe	Regierungstruppen
Regierungsverantwortung	Regierungsverantwortungen
Regierungsvorlage	Regierungsvorlagen
Regierungszeit	Regierungszeiten
Region	Regionen
Regionalbahn	Regionalbahnen
Regionalisierung	Regionalisierungen
Regionalliga	Regionalligen
Regisseurin	Regisseurinnen
Registrierung	Registrierungen
Reglementierung	Reglementierungen
Regulierung	Regulierungen
Regung	Regungen
Rehabilitation	Rehabilitationen
Rehabilitierung	Rehabilitierungen
Reiberei	Reibereien
Reibung	Reibungen
Reichsbahn	—
Reichsmark	—
Reichweite	Reichweiten
Reife	—
Reihe	Reihen
Reihenfolge	Reihenfolgen
Reihung	Reihungen
Reine	—
Reinheit	Reinheiten
Reinigung	Reinigungen
Reise	Reisen
Reiseführer	Reiseführer
Reisegruppe	Reisegruppen
Reisetasche	Reisetaschen
Reisezeit	Reisezeiten
Reiterin	Reiterinnen
Reithalle	Reithallen
Reklamation	Reklamationen
Reklame	Reklamen
Rekonstruktion	Rekonstruktionen
Rekordmarke	Rekordmarken
Rekordzahl	Rekordzahlen
Rekordzeit	Rekordzeiten
Rekrutierung	Rekrutierungen
Rektorin	Rektorinnen
Relation	Relationen
Relegation	Relegationen
Relevanz	—
Religion	Religionen
Religionsfreiheit	Religionsfreiheiten
Religionsgemeinschaft	Religionsgemeinschaften
Reliquie	Reliquien
Reminiszenz	Reminiszenzen
Remise	Remisen
Renaissance	Renaissancen
Rendite	Renditen
Rennbahn	Rennbahnen
Rennstrecke	Rennstrecken
Renovation	Renovationen
Renovierung	Renovierungen
Rente	Renten
Rentenkasse	Rentenkassen
Rentenreform	Rentenreformen
Rentenversicherung	Rentenversicherungen
Rentnerin	Rentnerinnen
Reorganisation	Reorganisationen
Reparatur	Reparaturen
Reparaturarbeit	—
Replik	Repliken
Reportage	Reportagen
Reporterin	Reporterinnen
Repressalie	Repressalien
Repression	Repressionen
Reproduktion	Reproduktionen
Republik	Republiken
Reputation	—
Reservation	Reservationen
Reserve	Reserven
Reservierung	Reservierungen
Residenz	Residenzen
Resignation	Resignationen
Resistenz	Resistenzen
Resolution	Resolutionen
Resonanz	Resonanzen
Resozialisierung	Resozialisierungen
Ressource	Ressourcen
Restaurierung	Restaurierungen
Restkarte	Restkarten
Restlaufzeit	Restlaufzeiten
Restriktion	Restriktionen
Restrukturierung	Restrukturierungen
Retour	Retouren
Rettung	Rettungen
Rettungsaktion	Rettungsaktionen
Rettungskraft	Rettungskräfte
Rettungsmannschaft	Rettungsmannschaften
Reue	Reuen
Revanche	Revanchen
Reverenz	Reverenzen
Revision	Revisionen
Revitalisierung	Revitalisierungen
Revolte	Revolten
Revolution	Revolutionen
Revue	Revuen
Rezension	Rezensionen
Rezeption	Rezeptionen
Rezeptur	Rezepturen
Rezession	Rezessionen
Rhetorik	Rhetoriken
Rhone	—
Rhythmik	Rhythmiken
Richterin	Richterinnen
Richterskala	—
Richtigkeit	Richtigkeiten
Richtlinie	Richtlinien
Richtung	Richtungen
Ricke	Ricken
Riege	Riegen
Rinde	Rinden
Rinderseuche	Rinderseuchen
Rinne	Rinnen
Rippe	Rippen
Risikobereitschaft	—
Risikogruppe	Risikogruppen
Risikovorsorge	—
Ritze	Ritzen
Rivalin	Rivalinnen
Robbe	Robben
Robe	Roben
Rochade	Rochaden
Rockband	Rockbands
Rockmusik	—
Rodung	Rodungen
Rohrleitung	Rohrleitungen
Rolle	Rollen
Rollenverteilung	Rollenverteilungen
Rolltreppe	Rolltreppen
Romantik	Romantiken
Romanze	Romanzen
Rose	Rosen
Rosine	Rosinen
Rotation	Rotationen
Route	Routen
Routine	Routinen
Rubrik	Rubriken
Rufnummer	Rufnummern
Ruhe	Ruhen
Ruhepause	Ruhepausen
Ruhestätte	Ruhestätten
Ruhestörung	Ruhestörungen
Ruine	Ruinen
Runde	Runden
Rundfahrt	Rundfahrten
Rundfunkanstalt	Rundfunkanstalten
Rundreise	Rundreisen
Rundschau	Rundschauen
Rundung	Rundungen
Rune	Runen
Runge	Rungen
Rus	—
Russin	Russinnen
Russlanddeutsche	Russlanddeutschen
Rute	Ruten
Rutsche	Rutschen
Räumung	Räumungen
Röhre	Röhren
Saar	—
Saat	Saaten
Sabotage	Sabotagen
Sachbearbeiterin	Sachbearbeiterinnen
Sache	Sachen
Sachfrage	Sachfragen
Sachkenntnis	Sachkenntnisse
Sachlage	Sachlagen
Sachlichkeit	Sachlichkeiten
Sachspende	Sachspenden
Sackgasse	Sackgassen
Safari	Safaris
Saga	Sagas
Sage	Sagen
Sahara	—
Sahne	Sahnen
Saison	Saisons
Saisonniederlage	Saisonniederlagen
Saite	Saiten
Salbe	Salben
Saline	Salinen
Salve	Salven
Salzach	—
Salzburgerin	Salzburgerinnen
Sammelaktion	Sammelaktionen
Sammelklage	Sammelklagen
Sammelstelle	Sammelstellen
Sammlung	Sammlungen
Sandale	Sandalen
Sanierung	Sanierungen
Sanktion	Sanktionen
Satire	Satiren
Satzung	Satzungen
Sauberkeit	Sauberkeiten
Sauce	Saucen
Sauerei	Sauereis
Sauna	Saunas
Schablone	Schablonen
Schachtel	Schachteln
Schadenersatzforderung	Schadenersatzforderungen
Schadenersatzklage	Schadenersatzklagen
Schadenfreude	—
Schadensbegrenzung	Schadensbegrenzungen
Schadenssumme	Schadenssummen
Schadstoffbelastung	Schadstoffbelastungen
Schaffung	—
Schale	Schalen
Schalke	Schalken
Schallmauer	Schallmauern
Schallplatte	Schallplatten
Schalterhalle	Schalterhallen
Schaltstelle	Schaltstellen
Schaltung	Schaltungen
Scham	—
Schande	Schanden
Scharia	—
Schattenseite	Schattenseiten
Schattenwirtschaft	Schattenwirtschaften
Schattierung	Schattierungen
Schatzkammer	Schatzkammern
Schatzmeisterin	Schatzmeisterinnen
Schau	Schauen
Schaufel	Schaufeln
Schaukel	Schaukeln
Schauspielerei	Schauspielereis
Schauspielerin	Schauspielerinnen
Schauspielschule	Schauspielschulen
Schautafel	Schautafeln
Scheckkarte	Scheckkarten
Scheibe	Scheiben
Scheidung	Scheidungen
Scheiße	Scheißen
Schelte	Schelten
Schenke	Schenken
Schenkung	Schenkungen
Scherbe	Scherben
Schere	Scheren
Scheu	Scheus
Scheuer	Scheuern
Scheune	Scheunen
Schicht	Schichten
Schichte	Schichten
Schiene	Schienen
Schießerei	Schießereis
Schifffahrt	Schifffahrten
Schikane	Schikanen
Schilderung	Schilderungen
Schippe	Schippen
Schirmherrschaft	Schirmherrschaften
Schizophrenie	Schizophrenien
Schlacht	Schlachten
Schlachtung	Schlachtungen
Schlaftablette	Schlaftabletten
Schlagkraft	—
Schlagzeile	Schlagzeilen
Schlammschlacht	Schlammschlachten
Schlamperei	Schlampereien
Schlange	Schlangen
Schlappe	Schlappen
Schleimhaut	Schleimhäute
Schleppe	Schleppen
Schleuse	Schleusen
Schlichtheit	—
Schlichtung	Schlichtungen
Schliere	Schlieren
Schließung	Schließungen
Schlinge	Schlingen
Schlucht	Schluchten	Schlüchte
Schlussfolgerung	Schlussfolgerungen
Schlussminute	Schlussminuten
Schlussphase	Schlussphasen
Schlussrunde	Schlussrunden
Schmach	—
Schmerzgrenze	Schmerzgrenzen
Schmiede	Schmieden
Schmiererei	Schmierereien
Schminke	Schminken
Schnauze	Schnauzen
Schnecke	Schnecken
Schneedecke	Schneedecken
Schneekanone	Schneekanonen
Schneemasse	Schneemassen
Schneide	Schneiden
Schneise	Schneisen
Schnelligkeit	Schnelligkeiten
Schnitte	Schnitten
Schnittstelle	Schnittstellen
Schnittwunde	Schnittwunden
Schokolade	Schokoladen
Scholle	Schollen
Schonfrist	Schonfristen
Schonung	Schonungen
Schranke	Schranken
Schraube	Schrauben
Schrecksekunde	Schrecksekunden
Schreibmaschine	Schreibmaschinen
Schreibweise	Schreibweisen
Schreinerei	Schreinereien
Schrift	Schriften
Schriftrolle	Schriftrollen
Schriftstellerin	Schriftstellerinnen
Schublade	Schubladen
Schuhgröße	Schuhgrößen
Schulbank	Schulbänke
Schulbildung	—
Schuld	Schulden
Schuldenlast	Schuldenlasten
Schuldnerberatung	Schuldnerberatungen
Schuldzuweisung	Schuldzuweisungen
Schule	Schulen
Schulform	Schulformen
Schulgemeinde	Schulgemeinden
Schulklasse	Schulklassen
Schulleiterin	Schulleiterinnen
Schulleitung	Schulleitungen
Schulmedizin	—
Schulpflicht	Schulpflichten
Schulpolitik	Schulpolitiken
Schulstufe	Schulstufen
Schulstunde	Schulstunden
Schulter	Schultern
Schulterverletzung	Schulterverletzungen
Schulung	Schulungen
Schulverwaltung	Schulverwaltungen
Schulzeit	Schulzeiten
Schusslinie	Schusslinien
Schusswaffe	Schusswaffen
Schutzgemeinschaft	Schutzgemeinschaften
Schutztruppe	Schutztruppen
Schutzzone	Schutzzonen
Schwachstelle	Schwachstellen
Schwalbe	Schwalben
Schwangere	Schwangeren
Schwangerschaft	Schwangerschaften
Schwankung	Schwankungen
Schwarzarbeit	Schwarzarbeiten
Schwedin	Schwedinnen
Schweigeminute	Schweigeminuten
Schweigepflicht	Schweigepflichten
Schweinepest	—
Schweinerei	Schweinereien
Schweiz	Schweizen
Schweizerin	Schweizerinnen
Schwelle	Schwellen
Schwere	—
Schwerelosigkeit	Schwerelosigkeiten
Schwerkraft	Schwerkräfte
Schwermut	—
Schwester	Schwestern
Schwesterpartei	Schwesterparteien
Schwiegermutter	Schwiegermütter
Schwiegertochter	Schwiegertöchter
Schwierigkeit	Schwierigkeiten
Schwimmerin	Schwimmerinnen
Schwimmhalle	Schwimmhallen
Schwinge	Schwingen
Schwingung	Schwingungen
Schwitze	Schwitzen
Schwäche	Schwächen
Schönheit	Schönheiten
Schöpfung	Schöpfungen
Schüchternheit	Schüchternheiten
Schürze	Schürzen
Schüssel	Schüsseln
Scientology	—
Sechs	Sechsen
Sechzig	Sechzigen
Seele	Seelen
Seelsorge	—
Seemeile	Seemeilen
Segnung	Segnungen
Sehenswürdigkeit	Sehenswürdigkeiten
Sehne	Sehnen
Sehnsucht	Sehnsüchte
Seide	Seiden
Seife	Seifen
Seifenblase	Seifenblasen
Seifenoper	Seifenopern
Seilbahn	Seilbahnen
Seilschaft	Seilschaften
Seite	Seiten
Seitenlinie	Seitenlinien
Seitenstraße	Seitenstraßen
Sekretärin	Sekretärinnen
Sekte	Sekten
Sektion	Sektionen
Sekundarschule	Sekundarschulen
Sekunde	Sekunden
Sekundenschnelle	Sekundenschnellen
Selbstbedienung	—
Selbstbehauptung	Selbstbehauptungen
Selbstbestimmung	Selbstbestimmungen
Selbstdarstellung	Selbstdarstellungen
Selbsthilfe	Selbsthilfen
Selbsthilfegruppe	Selbsthilfegruppen
Selbstinszenierung	Selbstinszenierungen
Selbstironie	—
Selbstkontrolle	Selbstkontrollen
Selbstkritik	Selbstkritiken
Selbstsicherheit	Selbstsicherheiten
Selbstverantwortung	Selbstverantwortungen
Selbstverpflichtung	Selbstverpflichtungen
Selbstverteidigung	Selbstverteidigungen
Selbstverwaltung	Selbstverwaltungen
Selbstverwirklichung	Selbstverwirklichungen
Selbstzerstörung	Selbstzerstörungen
Selektion	Selektionen
Seltenheit	Seltenheiten
Semmel	Semmeln
Senatorin	Senatorinnen
Senatsverwaltung	Senatsverwaltungen
Sendeanlage	Sendeanlagen
Sendezeit	Sendezeiten
Sendung	Sendungen
Seniorin	Seniorinnen
Senke	Senken
Senkung	Senkungen
Senna	Sennas
Sensation	Sensationen
Sense	Sensen
Sensibilität	Sensibilitäten
Sequenz	Sequenzen
Serenade	Serenaden
Serie	Serien
Serienausstattung	Serienausstattungen
Serra	Serras
Serviceleistung	Serviceleistungen
Servolenkung	Servolenkungen
Seuche	Seuchen
Sexualität	Sexualitäten
Show	Shows
Sichel	Sicheln
Sicherheit	Sicherheiten
Sicherheitsdirektion	Sicherheitsdirektionen
Sicherheitsfrage	Sicherheitsfragen
Sicherheitsgarantie	Sicherheitsgarantien
Sicherheitskraft	Sicherheitskräfte
Sicherheitslage	Sicherheitslagen
Sicherheitsmaßnahme	Sicherheitsmaßnahmen
Sicherheitspolitik	Sicherheitspolitiken
Sicherheitstechnik	Sicherheitstechniken
Sicherheitsvorkehrung	Sicherheitsvorkehrungen
Sicherheitszone	Sicherheitszonen
Sicherstellung	Sicherstellungen
Sicherung	Sicherungen
Sicherungsverwahrung	Sicherungsverwahrungen
Sicht	Sichten
Sichtung	Sichtungen
Sichtweise	Sichtweisen
Sichtweite	Sichtweiten
Sieben	Siebenen	Sieben
Siedlung	Siedlungen
Siegerehrung	Siegerehrungen
Siegerin	Siegerinnen
Siegermacht	Siegermächte
Siegesserie	Siegesserien
Sierra	Sierras	Sierren
Signalwirkung	Signalwirkungen
Signatur	Signaturen
Silbe	Silben
Silbermedaille	Silbermedaillen
Silhouette	Silhouetten
Silvesternacht	Silvesternächte
Simulation	Simulationen
Sinfonie	Sinfonien
Sinnhaftigkeit	—
Sinnlichkeit	Sinnlichkeiten
Sintflut	Sintfluten
Sirene	Sirenen
Sitcom	Sitcoms
Site	Sites
Sitte	Sitten
Situation	Situationen
Sitzbank	Sitzbänke
Sitzgelegenheit	Sitzgelegenheiten
Sitzung	Sitzungen
Sixt	Sixte	Sixts
Skala	Skalas
Skepsis	—
Skipiste	Skipisten
Skischule	Skischulen
Skizze	Skizzen
Sklaverei	—
Sklerose	Sklerosen
Skulptur	Skulpturen
Slowakei	—
Society	Societies
Soforthilfe	Soforthilfen
Software	Softwaren
Sohle	Sohlen
Soja	Sojen
Solaranlage	Solaranlagen
Solarenergie	Solarenergien
Solarzelle	Solarzellen
Soldatin	Soldatinnen
Sole	Solen
Solidargemeinschaft	Solidargemeinschaften
Solidarität	Solidaritäten
Solistin	Solistinnen
Sommerakademie	Sommerakademien
Sommerfrische	Sommerfrischen
Sommernacht	Sommernächte
Sommerpause	Sommerpausen
Sommersaison	Sommersaisons	Sommersaisonen
Sommerzeit	Sommerzeiten
Sonate	Sonaten
Sonde	Sonden
Sonderausgabe	Sonderausgaben
Sonderausstellung	Sonderausstellungen
Sondereinheit	Sondereinheiten
Sondergenehmigung	Sondergenehmigungen
Sonderklasse	Sonderklassen
Sonderkommission	Sonderkommissionen
Sonderregelung	Sonderregelungen
Sonderschau	Sonderschauen
Sonderschule	Sonderschulen
Sondersitzung	Sondersitzungen
Sonderstellung	Sonderstellungen
Sonderzahlung	Sonderzahlungen
Sonne	Sonnen
Sonnenblume	Sonnenblumen
Sonnenbrille	Sonnenbrillen
Sonneneinstrahlung	Sonneneinstrahlungen
Sonnenenergie	—
Sonnenfinsternis	Sonnenfinsternisse
Sonntagsarbeit	—
Sonntagsrede	Sonntagsreden
Sonntagszeitung	Sonntagszeitungen
Sopranistin	Sopranistinnen
Sorge	Sorgen
Sorgfalt	—
Sorte	Sorten
Sowjetrepublik	Sowjetrepubliken
Sowjetunion	—
Sozialabgabe	Sozialabgaben
Sozialarbeit	—
Sozialarbeiterin	Sozialarbeiterinnen
Sozialdemokratie	Sozialdemokratien
Sozialdemokratin	Sozialdemokratinnen
Sozialforschung	Sozialforschungen
Sozialgeschichte	Sozialgeschichten
Sozialhilfe	Sozialhilfen
Sozialisation	Sozialisationen
Sozialleistung	Sozialleistungen
Sozialministerin	Sozialministerinnen
Sozialpartnerschaft	Sozialpartnerschaften
Sozialpolitik	—
Sozialreform	Sozialreformen
Sozialsenatorin	Sozialsenatorinnen
Sozialstation	Sozialstationen
Sozialversicherung	Sozialversicherungen
Sozialwissenschaft	Sozialwissenschaften
Sozialwohnung	Sozialwohnungen
Soziologie	Soziologien
Soziologin	Soziologinnen
Soße	Soßen
Spaghetti	—
Spalte	Spalten
Spaltung	Spaltungen
Spanierin	Spanierinnen
Spanne	Spannen
Spannung	Spannungen
Spannweite	Spannweiten
Spareinlage	Spareinlagen
Sparkasse	Sparkassen
Sparpolitik	—
Sparsamkeit	Sparsamkeiten
Sparte	Sparten
Spedition	Speditionen
Speerspitze	Speerspitzen
Speicherung	Speicherungen
Speise	Speisen
Speisekarte	Speisekarten
Spekulation	Spekulationen
Spende	Spenden
Spendenaktion	Spendenaktionen
Sperre	Sperren
Sperrstunde	Sperrstunden
Sperrung	Sperrungen
Spesen	—
Spezialeinheit	Spezialeinheiten
Spezialisierung	Spezialisierungen
Spezialistin	Spezialistinnen
Spezies	Spezies	Spezien
Spezifikation	Spezifikationen
Spiegelung	Spiegelungen
Spielart	Spielarten
Spielbank	Spielbanken
Spieldauer	Spieldauern
Spielerei	Spielereien
Spielerin	Spielerinnen
Spielfreude	Spielfreuden
Spielgemeinschaft	Spielgemeinschaften
Spielhalle	Spielhallen
Spielklasse	Spielklassen
Spielminute	Spielminuten
Spielpraxis	Spielpraxen
Spielregel	Spielregeln
Spielvereinigung	Spielvereinigungen
Spielweise	Spielweisen
Spielwiese	Spielwiesen
Spielzeit	Spielzeiten
Spinne	Spinnen
Spinnerei	Spinnereien
Spionage	Spionagen
Spirale	Spiralen
Spirituose	Spirituosen
Spitze	Spitzen
Spitzengruppe	Spitzengruppen
Spitzenkandidatin	Spitzenkandidatinnen
Spitzenklasse	Spitzenklassen
Spitzenkraft	Spitzenkräfte
Spitzenleistung	Spitzenleistungen
Spitzenmannschaft	Spitzenmannschaften
Spitzenposition	Spitzenpositionen
Spitzenzeit	Spitzenzeiten
Splittergruppe	Splittergruppen
Spontaneität	Spontaneitäten
Sportanlage	Sportanlagen
Sportart	Sportarten
Sporthalle	Sporthallen
Sporthilfe	Sporthilfen
Sportlerin	Sportlerinnen
Sportschule	Sportschulen
Sportveranstaltung	Sportveranstaltungen
Sportwelt	—
Sprache	Sprachen
Sprachlosigkeit	—
Sprachregelung	Sprachregelungen
Sprecherin	Sprecherinnen
Sprechstunde	Sprechstunden
Sprengkraft	Sprengkräfte
Sprengung	Sprengungen
Sprinterin	Sprinterinnen
Spritze	Spritzen
Spritztour	Spritztouren
Spur	Spuren
Spurensuche	Spurensuchen
Spülung	Spülungen
Staatengemeinschaft	Staatengemeinschaften
Staatsanleihe	Staatsanleihen
Staatsanwaltschaft	Staatsanwaltschaften
Staatsausgabe	Staatsausgaben
Staatsbahn	Staatsbahnen
Staatsbank	Staatsbanken
Staatsbibliothek	Staatsbibliotheken
Staatsduma	Staatsdumas
Staatsgewalt	Staatsgewalten
Staatsgrenze	Staatsgrenzen
Staatskanzlei	Staatskanzleien
Staatskasse	Staatskassen
Staatsliga	Staatsligen
Staatsmacht	—
Staatsmeisterschaft	Staatsmeisterschaften
Staatsoper	Staatsopern
Staatspolizei	Staatspolizeis
Staatsregierung	Staatsregierungen
Staatsschuld	Staatsschulden
Staatssicherheit	Staatssicherheiten
Staatsverschuldung	Staatsverschuldungen
Stabilisierung	Stabilisierungen
Stabilität	Stabilitäten
Stadt	Städte
Stadtautobahn	Stadtautobahnen
Stadtbahn	Stadtbahnen
Stadtbibliothek	Stadtbibliotheken
Stadtentwicklung	Stadtentwicklungen
Stadterneuerung	Stadterneuerungen
Stadtgemeinde	Stadtgemeinden
Stadtgeschichte	Stadtgeschichten
Stadtgrenze	Stadtgrenzen
Stadthalle	Stadthallen
Stadtkasse	Stadtkassen
Stadtmauer	Stadtmauern
Stadtmeisterschaft	Stadtmeisterschaften
Stadtmitte	Stadtmitten
Stadtplanung	Stadtplanungen
Stadtreinigung	Stadtreinigungen
Stadtrundfahrt	Stadtrundfahrten
Stadtverordnetenversammlung	Stadtverordnetenversammlungen
Stadtverwaltung	Stadtverwaltungen
Staffel	Staffeln
Staffelung	Staffelungen
Stagnation	Stagnationen
Stahlindustrie	Stahlindustrien
Stallung	Stallungen
Stammaktie	Stammaktien
Stammzelle	Stammzellen
Standardsituation	Standardsituationen
Standfestigkeit	Standfestigkeiten
Standortbestimmung	Standortbestimmungen
Stange	Stangen
Startbahn	Startbahnen
Starthilfe	Starthilfen
Startnummer	Startnummern
Startphase	Startphasen
Statik	—
Station	Stationen
Stationierung	Stationierungen
Statistik	Statistiken
Statt	Stätten
Statue	Statuen
Statur	Staturen
Staude	Stauden
Steckdose	Steckdosen
Steiermark	—
Steigerung	Steigerungen
Steigerungsrate	Steigerungsraten
Steigung	Steigungen
Steinkohle	Steinkohlen
Steinzeit	—
Stele	Stelen
Stelle	Stellen
Stellung	Stellungen
Stellungnahme	Stellungnahmen
Stellvertreterin	Stellvertreterinnen
Stellwand	Stellwände
Stelze	Stelzen
Steppe	Steppen
Sterbe	Sterben
Sterbehilfe	Sterbehilfen
Sterblichkeit	Sterblichkeiten
Stereoanlage	Stereoanlagen
Sternstunde	Sternstunden
Sternwarte	Sternwarten
Steuerbefreiung	Steuerbefreiungen
Steuerbelastung	Steuerbelastungen
Steuereinnahme	Steuereinnahmen
Steuerentlastung	Steuerentlastungen
Steuererleichterung	Steuererleichterungen
Steuerfahndung	Steuerfahndungen
Steuerfreiheit	Steuerfreiheiten
Steuerhinterziehung	Steuerhinterziehungen
Steuerlast	Steuerlasten
Steuerpolitik	Steuerpolitiken
Steuerreform	Steuerreformen
Steuerschuld	Steuerschulden
Steuersenkung	Steuersenkungen
Steuerung	Steuerungen
Stewardess	Stewardessen
Stichprobe	Stichproben
Stichwahl	Stichwahlen
Stickerei	Stickereis
Stiefmutter	Stiefmütter
Stiftskirche	Stiftskirchen
Stiftung	Stiftungen
Stille	—
Stilllegung	Stilllegungen
Stilrichtung	Stilrichtungen
Stimmabgabe	Stimmabgaben
Stimme	Stimmen
Stimmung	Stimmungen
Stimmungslage	Stimmungslagen
Stimmungsmache	—
Stippvisite	Stippvisiten
Stirn	Stirnen
Stolle	Stollen
Story	Storys
Stoßstange	Stoßstangen
Strafanstalt	Strafanstalten
Strafanzeige	Strafanzeigen
Strafe	Strafen
Straffreiheit	Straffreiheiten
Straffung	Straffungen
Strafgefangene	Strafgefangenen
Strafkammer	Strafkammern
Strafprozessordnung	Strafprozessordnungen
Straftat	Straftaten
Strafverfolgung	Strafverfolgungen
Strahlenbelastung	Strahlenbelastungen
Strahlung	Strahlungen
Strapaze	Strapazen
Strategie	Strategien
Straßenbahn	Straßenbahnen
Straßensperre	Straßensperren
Strebe	Streben
Strecke	Strecken
Streicheleinheit	Streicheleinheiten
Streichung	Streichungen
Streife	Streifen
Streiterei	Streitereis
Streitfrage	Streitfragen
Streitigkeit	Streitigkeiten
Streitkraft	Streitkräfte
Streitmacht	Streitmächte
Strenge	Strengen
Streuobstwiese	Streuobstwiesen
Streuung	Streuungen
Stromerzeugung	—
Stromleitung	Stromleitungen
Stromversorgung	—
Stromwirtschaft	Stromwirtschaften
Strophe	Strophen
Struktur	Strukturen
Strukturpolitik	Strukturpolitiken
Strukturreform	Strukturreformen
Strumpfhose	Strumpfhosen
Strömung	Strömungen
Stube	Stuben
Studentenbewegung	Studentenbewegungen
Studentin	Studentinnen
Studie	Studien
Studienreise	Studienreisen
Studienrichtung	Studienrichtungen
Studienzeit	Studienzeiten
Stufe	Stufen
Stunde	Stunden
Sturheit	Sturheiten
Sturmflut	Sturmfluten
Stute	Stuten
Stärke	Stärken
Stätte	Stätten
Subkultur	Subkulturen
Substanz	Substanzen
Subvention	Subventionen
Subventionierung	Subventionierungen
Suchaktion	Suchaktionen
Suche	Suchen
Suchmaschine	Suchmaschinen
Sucht	Süchte	Suchten
Sudetendeutsche	Sudetendeutschen
Suite	Suiten
Summe	Summen
Supermacht	Supermächte
Suppe	Suppen
Suspendierung	Suspendierungen
Symbiose	Symbiosen
Symbolfigur	Symbolfiguren
Symbolik	Symboliken
Symmetrie	Symmetrien
Sympathie	Sympathien
Symphonie	Symphonien
Synagoge	Synagogen
Synergie	Synergien
Synode	Synoden
Synthese	Synthesen
Systematik	Systematiken
Szene	Szenen
Szenerie	Szenerien
Säge	Sägen
Säule	Säulen
Südseite	Südseiten
Sünde	Sünden
Tabakindustrie	—
Tabaksteuer	Tabaksteuern
Tabelle	Tabellen
Tabellenspitze	Tabellenspitzen
Tablette	Tabletten
Tafel	Tafeln
Tageskarte	Tageskarten
Tagesklinik	Tageskliniken
Tagesmutter	Tagesmütter
Tagesordnung	Tagesordnungen
Tagespolitik	Tagespolitiken
Tageszeit	Tageszeiten
Tageszeitung	Tageszeitungen
Tagung	Tagungen
Taille	Taillen
Taktik	Taktiken
Talfahrt	Talfahrten
Talkshow	Talkshows
Talsohle	Talsohlen
Talsperre	Talsperren
Talstation	Talstationen
Tankstelle	Tankstellen
Tanne	Tannen
Tante	Tanten
Tantieme	Tantiemen
Tanzeinlage	Tanzeinlagen
Tanzfläche	Tanzflächen
Tanzgruppe	Tanzgruppen
Tanzmusik	Tanzmusiken
Tanzschule	Tanzschulen
Tapete	Tapeten
Tarifautonomie	Tarifautonomien
Tarifkommission	Tarifkommissionen
Tarifpartei	Tarifparteien
Tarifpolitik	Tarifpolitiken
Tarifrunde	Tarifrunden
Tarifverhandlung	Tarifverhandlungen
Tarnung	Tarnungen
Tasche	Taschen
Taschenlampe	Taschenlampen
Tasse	Tassen
Tastatur	Tastaturen
Taste	Tasten
Tat	Taten
Tatkraft	—
Tatsache	Tatsachen
Tatwaffe	Tatwaffen
Tatzeit	Tatzeiten
Taufe	Taufen
Tauglichkeit	—
Taxe	Taxen
Teamarbeit	Teamarbeiten
Technik	Techniken
Technologie	Technologien
Teilhabe	—
Teilnahme	Teilnahmen
Teilnehmerin	Teilnehmerinnen
Teilnehmerzahl	Teilnehmerzahlen
Teilprivatisierung	Teilprivatisierungen
Teilrepublik	Teilrepubliken
Teilung	Teilungen
Teilzeit	Teilzeiten
Teilzeitarbeit	Teilzeitarbeiten
Telearbeit	Telearbeiten
Telefonaktion	Telefonaktionen
Telefongesellschaft	Telefongesellschaften
Telefonie	—
Telefonkarte	Telefonkarten
Telefonleitung	Telefonleitungen
Telefonnummer	Telefonnummern
Telefonrechnung	Telefonrechnungen
Telefonzelle	Telefonzellen
Telekom	—
Telekommunikation	Telekommunikationen
Television	—
Temperatur	Temperaturen
Tendenz	Tendenzen
Tennisspielerin	Tennisspielerinnen
Terminologie	Terminologien
Terra	—
Terrasse	Terrassen
Terrorgruppe	Terrorgruppen
Terrororganisation	Terrororganisationen
Testfahrt	Testfahrten
Testperson	Testpersonen
Testphase	Testphasen
Teststrecke	Teststrecken
Teuerung	Teuerungen
Teuerungsrate	Teuerungsraten
Textilindustrie	Textilindustrien
Textverarbeitung	Textverarbeitungen
Theatergruppe	Theatergruppen
Theke	Theken
Thematik	Thematiken
Themse	—
Theologie	Theologien
Theologin	Theologinnen
Theorie	Theorien
Therapeutin	Therapeutinnen
Therapie	Therapien
Therme	Thermen
These	Thesen
Thesis	Theses
Tiefe	Tiefen
Tiefgarage	Tiefgaragen
Tierart	Tierarten
Tierhaltung	Tierhaltungen
Tierwelt	Tierwelten
Tilgung	Tilgungen
Tinte	Tinten
Tirolerin	Tirolerinnen
Tischlerei	Tischlereien
Titelrolle	Titelrollen
Titelseite	Titelseiten
Titelverteidigerin	Titelverteidigerinnen
Titelverteidigung	Titelverteidigungen
Tochter	Töchter
Tochterfirma	Tochterfirmen
Tochtergesellschaft	Tochtergesellschaften
Todesangst	Todesängste
Todesanzeige	Todesanzeigen
Todesfolge	Todesfolgen
Todesschwadron	Todesschwadronen
Todesstrafe	Todesstrafen
Todesursache	Todesursachen
Todsünde	Todsünden
Toilette	Toiletten
Toleranz	Toleranzen
Tolerierung	Tolerierungen
Tolle	Tollen
Tollwut	—
Tomate	Tomaten
Tombola	Tombolas
Tonhalle	Tonhallen
Tonlage	Tonlagen
Tonne	Tonnen
Topform	Topformen
Torchance	Torchancen
Torfrau	Torfrauen
Torte	Torten
Tortur	Torturen
Toskana	—
Totenwache	Totenwachen
Tour	Touren
Tourismusbranche	Tourismusbranchen
Tourismuswirtschaft	Tourismuswirtschaften
Touristenattraktion	Touristenattraktionen
Touristik	—
Touristin	Touristinnen
Tournee	Tourneen
Tracht	Trachten
Tradition	Traditionen
Trafik	Trafiken
Trage	Tragen
Tragik	—
Tragweite	Tragweiten
Tragödie	Tragödien
Trainerbank	Trainerbänke
Trainerin	Trainerinnen
Trainingseinheit	Trainingseinheiten
Trance	Trancen
Tranche	Tranchen
Transaktion	Transaktionen
Transformation	Transformationen
Transparenz	Transparenzen
Transplantation	Transplantationen
Trasse	Trassen
Traube	Trauben
Trauer	—
Trauerfamilie	Trauerfamilien
Trauerfeier	Trauerfeiern
Trauerfeierlichkeit	Trauerfeierlichkeiten
Traumwelt	Traumwelten
Traurigkeit	Traurigkeiten
Trauung	Trauungen
Trefferquote	Trefferquoten
Treffsicherheit	Treffsicherheiten
Trendsportart	Trendsportarten
Trendwende	Trendwenden
Trennlinie	Trennlinien
Trennung	Trennungen
Treppe	Treppen
Treue	—
Treuhand	—
Treuhandanstalt	—
Triebfeder	Triebfedern
Trillerpfeife	Trillerpfeifen
Trilogie	Trilogien
Trinkwasserversorgung	Trinkwasserversorgungen
Tristesse	Tristessen
Trockenheit	Trockenheiten
Troika	Troikas
Trommel	Trommeln
Trompete	Trompeten
Trophäe	Trophäen
Truhe	Truhen
Trunkenheit	—
Truppe	Truppen
Träne	Tränen
Trümmer	—
Tschechin	Tschechinnen
Tschechoslowakei	Tschechoslowakeis
Tube	Tuben
Tuberkulose	Tuberkulosen
Tugend	Tugenden
Tulpe	Tulpen
Turbine	Turbinen
Turbulenz	Turbulenzen
Turnerin	Turnerinnen
Turnhalle	Turnhallen
Type	Typen
Tyrannei	Tyranneis
Tätigkeit	Tätigkeiten
Tätowierung	Tätowierungen
Täuschung	Täuschungen
Tötung	Tötungen
Tür	Türen
Türglocke	Türglocken
Türkei	Türkeis
Türklingel	Türklingeln
Türschwelle	Türschwellen
Tüte	Tüten
Uhr	Uhren
Uhrzeit	Uhrzeiten
Ukraine	Ukrainen
Umarmung	Umarmungen
Umbauarbeit	Umbauarbeiten
Umbenennung	Umbenennungen
Umfahrung	Umfahrungen
Umfrage	Umfragen
Umgangsform	Umgangsformen
Umgangssprache	Umgangssprachen
Umgebung	Umgebungen
Umgehung	Umgehungen
Umgestaltung	Umgestaltungen
Umkehr	—
Umkehrung	Umkehrungen
Umkleidekabine	Umkleidekabinen
Umlage	Umlagen
Umlandgemeinde	Umlandgemeinden
Umlaufbahn	Umlaufbahnen
Umlaufrendite	Umlaufrenditen
Umleitung	Umleitungen
Umsatzrendite	Umsatzrenditen
Umsatzsteigerung	Umsatzsteigerungen
Umsatzsteuer	Umsatzsteuern
Umschau	Umschauen
Umschichtung	Umschichtungen
Umschuldung	Umschuldungen
Umschulung	Umschulungen
Umsetzung	Umsetzungen
Umsiedlung	Umsiedlungen
Umstrukturierung	Umstrukturierungen
Umverteilung	Umverteilungen
Umwandlung	Umwandlungen
Umwelt	Umwelten
Umweltbelastung	Umweltbelastungen
Umweltfrage	Umweltfragen
Umweltkatastrophe	Umweltkatastrophen
Umweltministerin	Umweltministerinnen
Umweltorganisation	Umweltorganisationen
Umweltpolitik	—
Umweltschutzorganisation	Umweltschutzorganisationen
Umwelttechnik	Umwelttechniken
Umweltverschmutzung	Umweltverschmutzungen
Umwidmung	Umwidmungen
Unachtsamkeit	Unachtsamkeiten
Unannehmlichkeit	Unannehmlichkeiten
Uneinigkeit	Uneinigkeiten
Unendlichkeit	Unendlichkeiten
Unfallstelle	Unfallstellen
Unfallursache	Unfallursachen
Unfallversicherung	Unfallversicherungen
Ungarin	Ungarinnen
Ungeduld	—
Ungerechtigkeit	Ungerechtigkeiten
Ungereimtheit	Ungereimtheiten
Ungewissheit	Ungewissheiten
Ungleichbehandlung	Ungleichbehandlungen
Ungleichheit	Ungleichheiten
Ungnade	Ungnaden
Uni	Unis
Uniform	Uniformen
Uniklinik	Unikliniken
Union	Unionen
Unionsfraktion	—
Unionspartei	Unionsparteien
Unit	Units
Universität	Universitäten
Unkenntlichkeit	—
Unkenntnis	Unkenntnisse
Unklarheit	Unklarheiten
Unmenge	Unmengen
Unmittelbarkeit	Unmittelbarkeiten
Unordnung	—
Unruhe	Unruhen
Unschuld	—
Unschuldsvermutung	Unschuldsvermutungen
Unsicherheit	Unsicherheiten
Unsterblichkeit	Unsterblichkeiten
Unstimmigkeit	Unstimmigkeiten
Untat	Untaten
Unterbrechung	Unterbrechungen
Unterbringung	Unterbringungen
Unterdrückung	Unterdrückungen
Untergrundorganisation	Untergrundorganisationen
Unterhaltung	Unterhaltungen
Unterhaltungselektronik	—
Unterhaltungsmusik	—
Unterhose	Unterhosen
Unterkunft	Unterkünfte
Unterlage	Unterlagen
Unterlassung	Unterlassungen
Untermalung	Untermalungen
Unternehmensberatung	Unternehmensberatungen
Unternehmensgruppe	Unternehmensgruppen
Unternehmenskultur	Unternehmenskulturen
Unternehmensleitung	Unternehmensleitungen
Unternehmerin	Unternehmerinnen
Unternehmung	Unternehmungen
Unterordnung	Unterordnungen
Unterredung	Unterredungen
Unterrichtsministerin	Unterrichtsministerinnen
Unterrichtsstunde	Unterrichtsstunden
Unterscheidung	Unterscheidungen
Unterschicht	Unterschichten
Unterschlagung	Unterschlagungen
Unterschrift	Unterschriften
Unterschriftenaktion	Unterschriftenaktionen
Unterschriftenliste	Unterschriftenlisten
Unterschriftensammlung	Unterschriftensammlungen
Unterseite	Unterseiten
Unterstufe	Unterstufen
Unterstützung	Unterstützungen
Untersuchung	Untersuchungen
Untersuchungshaft	—
Untersuchungskommission	Untersuchungskommissionen
Unterwelt	Unterwelten
Unterwerfung	Unterwerfungen
Unterwäsche	Unterwäschen
Unterzahl	—
Unterzeichnung	Unterzeichnungen
Untreue	—
Unvereinbarkeit	Unvereinbarkeiten
Unversehrtheit	—
Unwahrheit	Unwahrheiten
Unwissenheit	—
Unzahl	Unzahlen
Unzucht	—
Unzufriedenheit	Unzufriedenheiten
Urabstimmung	Urabstimmungen
Urananreicherung	Urananreicherungen
Urkunde	Urkunden
Urlauberin	Urlauberinnen
Urlaubsreise	Urlaubsreisen
Urlaubszeit	Urlaubszeiten
Urne	Urnen
Ursache	Ursachen
Ursachenforschung	Ursachenforschungen
Urzeit	Urzeiten
Utopie	Utopien
Vanille	Vanillen
Variable	Variablen
Variante	Varianten
Variation	Variationen
Vase	Vasen
Vaterschaft	Vaterschaften
Vega	Vegas
Vegetation	Vegetationen
Vehemenz	—
Vene	Venen
Verabredung	Verabredungen
Verabschiedung	Verabschiedungen
Verachtung	Verachtungen
Veranda	Veranden	Verandas
Verankerung	Verankerungen
Veranlagung	Veranlagungen
Veranlassung	Veranlassungen
Veranstalterin	Veranstalterinnen
Veranstaltung	Veranstaltungen
Veranstaltungsreihe	Veranstaltungsreihen
Verantwortlichkeit	Verantwortlichkeiten
Verantwortung	Verantwortungen
Verarbeitung	Verarbeitungen
Verarmung	Verarmungen
Verbandsgemeinde	Verbandsgemeinden
Verbandsliga	Verbandsligen
Verbannung	Verbannungen
Verbauung	Verbauungen
Verbesserung	Verbesserungen
Verbeugung	Verbeugungen
Verbilligung	Verbilligungen
Verbindlichkeit	Verbindlichkeiten
Verbindung	Verbindungen
Verbitterung	Verbitterungen
Verbraucherzentrale	Verbraucherzentralen
Verbreiterung	Verbreiterungen
Verbreitung	Verbreitungen
Verbrennung	Verbrennungen
Verbrennungsanlage	Verbrennungsanlagen
Verbundenheit	Verbundenheiten
Verdauung	Verdauungen
Verdichtung	Verdichtungen
Verdoppelung	Verdoppelungen
Verehrung	Verehrungen
Vereidigung	Vereidigungen
Vereinbarkeit	Vereinbarkeiten
Vereinbarung	Vereinbarungen
Vereinfachung	Vereinfachungen
Vereinheitlichung	Vereinheitlichungen
Vereinigung	Vereinigungen
Vereinnahmung	Vereinnahmungen
Vereinsgeschichte	Vereinsgeschichten
Vereinskasse	Vereinskassen
Verengung	Verengungen
Verfassung	Verfassungen
Verfassungsbeschwerde	Verfassungsbeschwerden
Verfassungsklage	Verfassungsklagen
Verfassungsreform	Verfassungsreformen
Verfehlung	Verfehlungen
Verfilmung	Verfilmungen
Verflechtung	Verflechtungen
Verfolgung	Verfolgungen
Verfolgungsjagd	Verfolgungsjagden
Verfremdung	Verfremdungen
Verfügung	Verfügungen
Verführung	Verführungen
Vergabe	Vergaben
Vergangenheit	Vergangenheiten
Vergebung	Vergebungen
Vergeltung	Vergeltungen
Vergessenheit	Vergessenheiten
Vergewaltigung	Vergewaltigungen
Vergiftung	Vergiftungen
Vergünstigung	Vergünstigungen
Verhaftung	Verhaftungen
Verhaltensregel	Verhaltensregeln
Verhaltensweise	Verhaltensweisen
Verhandlung	Verhandlungen
Verhandlungsposition	Verhandlungspositionen
Verhandlungsrunde	Verhandlungsrunden
Verharmlosung	Verharmlosungen
Verhinderung	Verhinderungen
Verkaufsstelle	Verkaufsstellen
Verkaufszahl	Verkaufszahlen
Verkehrsanbindung	Verkehrsanbindungen
Verkehrsbehinderung	Verkehrsbehinderungen
Verkehrsbelastung	Verkehrsbelastungen
Verkehrsberuhigung	Verkehrsberuhigungen
Verkehrsgesellschaft	Verkehrsgesellschaften
Verkehrskontrolle	Verkehrskontrollen
Verkehrsplanung	Verkehrsplanungen
Verkehrspolitik	Verkehrspolitiken
Verkehrssicherheit	—
Verkehrssituation	Verkehrssituationen
Verkehrstechnik	—
Verkehrsverbindung	Verkehrsverbindungen
Verkleidung	Verkleidungen
Verkleinerung	Verkleinerungen
Verknappung	Verknappungen
Verlagerung	Verlagerungen
Verlagsgruppe	Verlagsgruppen
Verlangsamung	Verlangsamungen
Verlautbarung	Verlautbarungen
Verlegenheit	Verlegenheiten
Verlegung	Verlegungen
Verleihung	Verleihungen
Verletzung	Verletzungen
Verletzungspause	Verletzungspausen
Verleumdung	Verleumdungen
Verlobung	Verlobungen
Verlockung	Verlockungen
Verlosung	Verlosungen
Verlustzone	Verlustzonen
Vermarktung	Vermarktungen
Vermehrung	Vermehrungen
Vermeidung	Vermeidungen
Vermessung	Vermessungen
Vermieterin	Vermieterinnen
Vermietung	Vermietungen
Verminderung	Verminderungen
Vermischung	Vermischungen
Vermittlung	Vermittlungen
Vermutung	Vermutungen
Vernehmlassung	Vernehmlassungen
Vernehmung	Vernehmungen
Vernetzung	Vernetzungen
Vernichtung	Vernichtungen
Vernissage	Vernissagen
Vernunft	—
Verordnung	Verordnungen
Verpackung	Verpackungen
Verpackungsverordnung	Verpackungsverordnungen
Verpflegung	Verpflegungen
Verpflichtung	Verpflichtungen
Verquickung	Verquickungen
Verrechnung	Verrechnungen
Verringerung	Verringerungen
Verräter	Verräter
Verrücktheit	Verrücktheiten
Versammlung	Versammlungen
Verschiebung	Verschiebungen
Verschiedenheit	Verschiedenheiten
Verschlechterung	Verschlechterungen
Verschleierung	Verschleierungen
Verschleppung	Verschleppungen
Verschlüsselung	Verschlüsselungen
Verschmelzung	Verschmelzungen
Verschmutzung	Verschmutzungen
Verschnaufpause	Verschnaufpausen
Verschuldung	Verschuldungen
Verschwendung	Verschwendungen
Verschwörung	Verschwörungen
Versenkung	Versenkungen
Versetzung	Versetzungen
Verseuchung	Verseuchungen
Versicherte	Versicherten
Versicherung	Versicherungen
Versicherungsgesellschaft	Versicherungsgesellschaften
Versicherungsgruppe	Versicherungsgruppen
Versicherungssumme	Versicherungssummen
Versicherungswirtschaft	Versicherungswirtschaften
Version	Versionen
Versorgung	Versorgungen
Versprechung	Versprechungen
Verspätung	Verspätungen
Verstaatlichung	Verstaatlichungen
Versteigerung	Versteigerungen
Verstimmung	Verstimmungen
Verstrickung	Verstrickungen
Verstärkung	Verstärkungen
Versuchsperson	Versuchspersonen
Versuchung	Versuchungen
Versöhnung	Versöhnungen
Vertagung	Vertagungen
Verteidigerin	Verteidigerinnen
Verteidigung	Verteidigungen
Verteidigungspolitik	—
Verteilung	Verteilungen
Verteuerung	Verteuerungen
Vertiefung	Vertiefungen
Vertragsunterzeichnung	Vertragsunterzeichnungen
Vertragsverhandlung	Vertragsverhandlungen
Vertrauensfrage	Vertrauensfragen
Vertraulichkeit	Vertraulichkeiten
Vertrautheit	—
Vertreibung	Vertreibungen
Vertreterin	Vertreterinnen
Vertretung	Vertretungen
Verunglimpfung	Verunglimpfungen
Verunreinigung	Verunreinigungen
Verunsicherung	Verunsicherungen
Veruntreuung	Veruntreuungen
Verurteilung	Verurteilungen
Verve	—
Verwahrlosung	Verwahrlosungen
Verwahrung	Verwahrungen
Verwaltung	Verwaltungen
Verwaltungsreform	Verwaltungsreformen
Verwandlung	Verwandlungen
Verwandtschaft	Verwandtschaften
Verwarnung	Verwarnungen
Verwechslung	Verwechslungen
Verweigerung	Verweigerungen
Verweildauer	Verweildauern
Verwendung	Verwendungen
Verwerfung	Verwerfungen
Verwertung	Verwertungen
Verwicklung	Verwicklungen
Verwirklichung	Verwirklichungen
Verwirrung	Verwirrungen
Verwunderung	—
Verwüstung	Verwüstungen
Verzahnung	Verzahnungen
Verzeihung	Verzeihungen
Verzerrung	Verzerrungen
Verzierung	Verzierungen
Verzinsung	Verzinsungen
Verzweiflung	Verzweiflungen
Verzögerung	Verzögerungen
Veränderung	Veränderungen
Veröffentlichung	Veröffentlichungen
Vetternwirtschaft	—
Vibration	Vibrationen
Videoaufnahme	Videoaufnahmen
Videokamera	Videokameras
Videokassette	Videokassetten
Videokonferenz	Videokonferenzen
Videothek	Videotheken
Vielfalt	—
Vielseitigkeit	Vielseitigkeiten
Vielzahl	—
Vier	Vieren
Viererkette	Viererketten
Vierschanzentournee	Vierschanzentourneen	Vierschanzentournees
Viertelmillion	Viertelmillionen
Viertelstunde	Viertelstunden
Vignette	Vignetten
Villa	Villas
Violine	Violinen
Vision	Visionen
Visite	Visiten
Visitenkarte	Visitenkarten
Vista	Vistas
Vita	Vitae	Viten
Vitrine	Vitrinen
Vizekanzlerin	Vizekanzlerinnen
Vogelart	Vogelarten
Vogelgrippe	—
Vokabel	Vokabeln	Vokabel
Volksabstimmung	Volksabstimmungen
Volksarmee	Volksarmeen
Volksbefragung	Volksbefragungen
Volksfront	Volksfronten
Volksgruppe	Volksgruppen
Volkshochschule	Volkshochschulen
Volksinitiative	Volksinitiativen
Volkskammer	Volkskammern
Volksmusik	Volksmusiken
Volkspartei	Volksparteien
Volksrepublik	Volksrepubliken
Volksschule	Volksschulen
Volksverhetzung	Volksverhetzungen
Volksvertretung	Volksvertretungen
Volkswirtschaft	Volkswirtschaften
Vollbremsung	Vollbremsungen
Vollendung	Vollendungen
Volleyballerin	Volleyballerinnen
Vollmacht	Vollmachten
Vollstreckung	Vollstreckungen
Vollversammlung	Vollversammlungen
Vollzeit	—
Vorahnung	Vorahnungen
Voranmeldung	Voranmeldungen
Vorarbeit	Vorarbeiten
Voraussage	Voraussagen
Voraussetzung	Voraussetzungen
Voraussicht	Voraussichten
Vorauswahl	Vorauswahlen
Vorauszahlung	Vorauszahlungen
Vorbedingung	Vorbedingungen
Vorbereitung	Vorbereitungen
Vorbereitungszeit	Vorbereitungszeiten
Vorbeugung	Vorbeugungen
Vorbildfunktion	Vorbildfunktionen
Vorderhand	Vorderhände
Vorderseite	Vorderseiten
Vorentscheidung	Vorentscheidungen
Vorfahrt	Vorfahrten
Vorfreude	Vorfreuden
Vorgabe	Vorgaben
Vorgangsweise	Vorgangsweisen
Vorgehensweise	Vorgehensweisen
Vorgeschichte	Vorgeschichten
Vorhand	Vorhände
Vorherrschaft	Vorherrschaften
Vorhersage	Vorhersagen
Vorhut	Vorhuten
Vorkehrung	Vorkehrungen
Vorkenntnis	Vorkenntnisse
Vorladung	Vorladungen
Vorlage	Vorlagen
Vorleistung	Vorleistungen
Vorlesung	Vorlesungen
Vorliebe	Vorlieben
Vormachtstellung	Vormachtstellungen
Vorreiterrolle	Vorreiterrollen
Vorrichtung	Vorrichtungen
Vorrunde	Vorrunden
Vorsaison	Vorsaisonen
Vorschau	Vorschaus
Vorschrift	Vorschriften
Vorsehung	Vorsehungen
Vorsicht	—
Vorsichtsmaßnahme	Vorsichtsmaßnahmen
Vorsorge	—
Vorsorgeuntersuchung	Vorsorgeuntersuchungen
Vorspeise	Vorspeisen
Vorstadt	Vorstädte
Vorstandssitzung	Vorstandssitzungen
Vorstandswahl	Vorstandswahlen
Vorstellung	Vorstellungen
Vorstellungskraft	Vorstellungskräfte
Vorstrafe	Vorstrafen
Vorstufe	Vorstufen
Vortragsreihe	Vortragsreihen
Voruntersuchung	Voruntersuchungen
Vorverkaufsstelle	Vorverkaufsstellen
Vorverurteilung	Vorverurteilungen
Vorwahl	Vorwahlen
Vorwarnung	Vorwarnungen
Vorweihnachtszeit	—
Vorwoche	Vorwochen
Vorzeit	Vorzeiten
Vorzugsaktie	Vorzugsaktien
Vorzugsstimme	Vorzugsstimmen
Vox	Voces
Waadt	—
Waage	Waagen
Waagschale	Waagschalen
Wachablösung	Wachablösungen
Wachau	—
Wache	Wachen
Wachsamkeit	—
Wachstumschance	Wachstumschancen
Wachstumsprognose	Wachstumsprognosen
Wachstumsrate	Wachstumsraten
Wade	Waden
Waffe	Waffen
Waffel	Waffeln
Waffengewalt	—
Waffenlieferung	Waffenlieferungen
Waffenruhe	Waffenruhen
Wagenburg	Wagenburgen
Wahl	Wahlen
Wahlbeteiligung	Wahlbeteiligungen
Wahlfreiheit	Wahlfreiheiten
Wahlheimat	Wahlheimaten
Wahlkampagne	Wahlkampagnen
Wahlkommission	Wahlkommissionen
Wahlniederlage	Wahlniederlagen
Wahlperiode	Wahlperioden
Wahlschlappe	Wahlschlappen
Wahlurne	Wahlurnen
Wahlveranstaltung	Wahlveranstaltungen
Wahlwerbung	Wahlwerbungen
Wahnvorstellung	Wahnvorstellungen
Wahrhaftigkeit	Wahrhaftigkeiten
Wahrheit	Wahrheiten
Wahrnehmung	Wahrnehmungen
Wahrscheinlichkeit	Wahrscheinlichkeiten
Wahrung	—
Waise	Waisen
Waldorfschule	Waldorfschulen
Waldstatt	Waldstätte
Wallfahrt	Wallfahrten
Wallfahrtskirche	Wallfahrtskirchen
Walz	—
Walze	Walzen
Wand	Wände
Wanderausstellung	Wanderausstellungen
Wanderschaft	Wanderschaften
Wanderung	Wanderungen
Wandlung	Wandlungen
Wandmalerei	Wandmalereien
Wange	Wangen
Wanne	Wannen
Want	Wanten
Wanze	Wanzen
Ware	Waren
Warnung	Warnungen
Warte	Warten
Warteliste	Wartelisten
Warteschlange	Warteschlangen
Warteschleife	Warteschleifen
Wartezeit	Wartezeiten
Wartung	Wartungen
Waschmaschine	Waschmaschinen
Wasserkraft	—
Wasserleitung	Wasserleitungen
Wassermasse	Wassermassen
Wasserschutzpolizei	—
Wassertemperatur	Wassertemperaturen
Wasserversorgung	—
Wasserwirtschaft	Wasserwirtschaften
Webseite	Webseiten
Website	Websites
Wechselwirkung	Wechselwirkungen
Wegfahrsperre	Wegfahrsperren
Wegstrecke	Wegstrecken
Wehmut	—
Wehrmacht	Wehrmächte
Wehrpflicht	—
Weiblichkeit	Weiblichkeiten
Weichenstellung	Weichenstellungen
Weide	Weiden
Weigerung	Weigerungen
Weihnacht	—
Weihnachtsfeier	Weihnachtsfeiern
Weihnachtsgeschichte	Weihnachtsgeschichten
Weihnachtszeit	—
Weile	Weilen
Weinprobe	Weinproben
Weise	Weisen
Weisheit	Weisheiten
Weisung	Weisungen
Weite	Weiten
Weiterbildung	—
Weiterentwicklung	Weiterentwicklungen
Weiterfahrt	Weiterfahrten
Weitergabe	Weitergaben
Weitsicht	Weitsichten
Welle	Wellen
Wellenlänge	Wellenlängen
Wellness	—
Welt	Welten
Weltanschauung	Weltanschauungen
Weltausstellung	Weltausstellungen
Weltbank	Weltbanken
Weltelite	Welteliten
Weltgemeinschaft	Weltgemeinschaften
Weltgeschichte	—
Weltgesundheitsorganisation	—
Weltgruppe	Weltgruppen
Welthandelsorganisation	Welthandelsorganisationen
Weltklasse	Weltklassen
Weltliteratur	—
Weltmacht	Weltmächte
Weltmeisterin	Weltmeisterinnen
Weltmeisterschaft	Weltmeisterschaften
Weltmusik	Weltmusiken
Weltoffenheit	—
Weltordnung	Weltordnungen
Weltorganisation	Weltorganisationen
Weltpolitik	—
Weltpremiere	Weltpremieren
Weltrangliste	Weltranglisten
Weltranglistenerste	Weltranglistenersten
Weltreise	Weltreisen
Weltsicht	Weltsichten
Weltspitze	Weltspitzen
Weltstadt	Weltstädte
Weltwirtschaft	—
Weltwirtschaftskrise	Weltwirtschaftskrisen
Wendel	Wendeln
Wendung	Wendungen
Werbeagentur	Werbeagenturen
Werbeaktion	Werbeaktionen
Werbeeinnahme	Werbeeinnahmen
Werbekampagne	Werbekampagnen
Werbetrommel	Werbetrommeln
Werbewirtschaft	Werbewirtschaften
Werbung	Werbungen
Werft	Werften
Werkschau	Werkschauen
Werkstatt	Werkstätten
Wertberichtigung	Wertberichtigungen
Wertentwicklung	Wertentwicklungen
Wertsache	Wertsachen
Wertsteigerung	Wertsteigerungen
Wertung	Wertungen
Wertvorstellung	Wertvorstellungen
Weser	—
Wespe	Wespen
Westautobahn	Westautobahnen
Weste	Westen
Westküste	Westküsten
Westschweiz	—
Westseite	Westseiten
Wettbewerbsverzerrung	Wettbewerbsverzerrungen
Wette	Wetten
Wetterbedingung	Wetterbedingungen
Wetterlage	Wetterlagen
Wettervorhersage	Wettervorhersagen
Wettfahrt	Wettfahrten
Wichtigkeit	Wichtigkeiten
Widerrede	Widerreden
Widmung	Widmungen
Widrigkeit	Widrigkeiten
Wiederaufarbeitung	Wiederaufarbeitungen
Wiederaufarbeitungsanlage	Wiederaufarbeitungsanlagen
Wiederaufbereitungsanlage	Wiederaufbereitungsanlagen
Wiederaufnahme	Wiederaufnahmen
Wiederbelebung	Wiederbelebungen
Wiedereingliederung	Wiedereingliederungen
Wiederentdeckung	Wiederentdeckungen
Wiedergabe	Wiedergaben
Wiedergeburt	Wiedergeburten
Wiedergutmachung	Wiedergutmachungen
Wiederherstellung	Wiederherstellungen
Wiederholung	Wiederholungen
Wiederkehr	—
Wiedervereinigung	Wiedervereinigungen
Wiederverwertung	Wiederverwertungen
Wiederwahl	Wiederwahlen
Wiege	Wiegen
Wienerin	Wienerinnen
Wiese	Wiesen
Wiesn	Wiesn
Wildbahn	Wildbahnen
Wildnis	Wildnisse
Willensbildung	—
Wimper	Wimpern
Winde	Winden
Windel	Windeln
Windenergie	—
Windeseile	Windeseilen
Windgeschwindigkeit	Windgeschwindigkeiten
Windkraft	—
Windkraftanlage	Windkraftanlagen
Windschutzscheibe	Windschutzscheiben
Winterpause	Winterpausen
Wintersaison	Wintersaisons	Wintersaisonen
Wirbelsäule	Wirbelsäulen
Wirklichkeit	Wirklichkeiten
Wirksamkeit	—
Wirkung	Wirkungen
Wirtin	Wirtinnen
Wirtschaft	Wirtschaften
Wirtschaftlichkeit	—
Wirtschaftsforschung	Wirtschaftsforschungen
Wirtschaftsgemeinschaft	Wirtschaftsgemeinschaften
Wirtschaftshilfe	Wirtschaftshilfen
Wirtschaftskammer	Wirtschaftskammern
Wirtschaftskraft	Wirtschaftskräfte
Wirtschaftskrise	Wirtschaftskrisen
Wirtschaftslage	Wirtschaftslagen
Wirtschaftspolitik	Wirtschaftspolitiken
Wirtschaftssanktion	Wirtschaftssanktionen
Wirtschaftswissenschaft	Wirtschaftswissenschaften
Wirtschaftszeitung	Wirtschaftszeitungen
Wissenschaft	Wissenschaften
Wissenschaftlerin	Wissenschaftlerinnen
Witterung	Witterungen
Witwe	Witwen
Woche	Wochen
Wochenarbeitszeit	Wochenarbeitszeiten
Wochenstunde	Wochenstunden
Wochenzeitung	Wochenzeitungen
Woge	Wogen
Wohlfahrt	Wohlfahrten
Wohltat	Wohltaten
Wohltätigkeit	Wohltätigkeiten
Wohnanlage	Wohnanlagen
Wohnbebauung	Wohnbebauungen
Wohneinheit	Wohneinheiten
Wohngemeinschaft	Wohngemeinschaften
Wohngruppe	Wohngruppen
Wohnsiedlung	Wohnsiedlungen
Wohnung	Wohnungen
Wohnungsbaugesellschaft	Wohnungsbaugesellschaften
Wohnungsnot	Wohnungsnöte
Wolga	Wolgas
Wolke	Wolken
Wolle	Wollen
Wonne	Wonnen
Workstation	Workstations
Wortmeldung	Wortmeldungen
Wortwahl	—
Wucht	Wuchten
Wunde	Wunden
Wunschliste	Wunschlisten
Wurst	Würste
Wurz	Wurzen
Wurzel	Wurzeln
Wut	—
Währung	Währungen
Wärme	Wärmen
Wäsche	Wäschen
Wäscherei	Wäschereis
Wüste	Wüsten
Yacht	Yachten
Yoga	Yogas
Zahl	Zahlen
Zahlung	Zahlungen
Zahlungsmoral	—
Zahnpasta	Zahnpasten
Zange	Zangen
Zauberei	Zaubereis
Zauberformel	Zauberformeln
Zeche	Zechen
Zecke	Zecken
Zehe	Zehen
Zehn	Zehnen
Zeichnung	Zeichnungen
Zeile	Zeilen
Zeit	Zeiten
Zeitarbeit	—
Zeitbombe	Zeitbomben
Zeitenwende	Zeitenwenden
Zeitgeschichte	Zeitgeschichten
Zeitlang	—
Zeitlupe	Zeitlupen
Zeitmaschine	Zeitmaschinen
Zeitrechnung	Zeitrechnungen
Zeitreise	Zeitreisen
Zeitschrift	Zeitschriften
Zeitspanne	Zeitspannen
Zeitung	Zeitungen
Zeitungsanzeige	Zeitungsanzeigen
Zelle	Zellen
Zeltstadt	Zeltstädte
Zensur	Zensuren
Zentralbank	Zentralbanken
Zentrale	Zentralen
Zentralisierung	Zentralisierungen
Zentralregierung	Zentralregierungen
Zentralstelle	Zentralstellen
Zentralverriegelung	Zentralverriegelungen
Zeremonie	Zeremonien
Zerrissenheit	—
Zerrung	Zerrungen
Zerschlagung	Zerschlagungen
Zersplitterung	Zersplitterungen
Zerstörung	Zerstörungen
Zertifizierung	Zertifizierungen
Zeugenaussage	Zeugenaussagen
Zeugin	Zeuginnen
Ziege	Ziegen
Ziehung	Ziehungen
Zielgerade	Zielgeraden
Zielgruppe	Zielgruppen
Ziellinie	Ziellinien
Zielperson	Zielpersonen
Zielrichtung	Zielrichtungen
Zielscheibe	Zielscheiben
Zielsetzung	Zielsetzungen
Zielvorgabe	Zielvorgaben
Ziffer	Ziffern
Zigarette	Zigaretten
Zigarre	Zigarren
Zinssenkung	Zinssenkungen
Zinszahlung	Zinszahlungen
Zitadelle	Zitadellen
Zitrone	Zitronen
Zitterpartie	Zitterpartien
Zivilcourage	—
Zivilgesellschaft	Zivilgesellschaften
Zivilisation	Zivilisationen
Zollunion	Zollunionen
Zone	Zonen
Zubereitung	Zubereitungen
Zucht	Zuchten
Zufahrt	Zufahrten
Zuflucht	—
Zufriedenheit	Zufriedenheiten
Zugabe	Zugaben
Zugmaschine	Zugmaschinen
Zukunft	Zukünfte
Zukunftsangst	Zukunftsängste
Zukunftschance	Zukunftschancen
Zukunftsmusik	—
Zukunftsperspektive	Zukunftsperspektiven
Zukunftsvision	Zukunftsvisionen
Zulage	Zulagen
Zulassung	Zulassungen
Zulassungsstelle	Zulassungsstellen
Zulu	Zulu	Zulus
Zumutung	Zumutungen
Zunahme	Zunahmen
Zuneigung	Zuneigungen
Zunft	Zünfte
Zunge	Zungen
Zuordnung	Zuordnungen
Zurückhaltung	Zurückhaltungen
Zurückweisung	Zurückweisungen
Zusage	Zusagen
Zusammenarbeit	—
Zusammenfassung	Zusammenfassungen
Zusammenkunft	Zusammenkünfte
Zusammenlegung	Zusammenlegungen
Zusammensetzung	Zusammensetzungen
Zusammenstellung	Zusammenstellungen
Zusatzversicherung	Zusatzversicherungen
Zuschauerin	Zuschauerinnen
Zuschauerzahl	Zuschauerzahlen
Zuschrift	Zuschriften
Zusicherung	Zusicherungen
Zuspitzung	Zuspitzungen
Zustellung	Zustellungen
Zustimmung	Zustimmungen
Zutat	Zutaten
Zuteilung	Zuteilungen
Zuversicht	Zuversichten
Zuwachsrate	Zuwachsraten
Zuwanderung	Zuwanderungen
Zuweisung	Zuweisungen
Zuwendung	Zuwendungen
Zuzahlung	Zuzahlungen
Zwangsarbeit	Zwangsarbeiten
Zwangspause	Zwangspausen
Zwangsversteigerung	Zwangsversteigerungen
Zwanzig	Zwanzigen
Zwecke	Zwecken
Zwei	Zweien
Zweidrittelmehrheit	Zweidrittelmehrheiten
Zweigstelle	Zweigstellen
Zweitstimme	Zweitstimmen
Zwiebel	Zwiebeln
Zwischenbilanz	Zwischenbilanzen
Zwischenkriegszeit	Zwischenkriegszeiten
Zwischenrunde	Zwischenrunden
Zwischenstation	Zwischenstationen
Zwischenzeit	Zwischenzeiten
Zündschnur	Zündschnüre
Zündung	Zündungen
Änderung	Änderungen
Ära	Äras
Äußerung	Äußerungen
Öde	Öden
Öffentlichkeit	Öffentlichkeiten
Öffentlichkeitsarbeit	Öffentlichkeitsarbeiten
Öffnung	Öffnungen
Ökonomie	Ökonomien
Überdosis	Überdosen
Übereinstimmung	Übereinstimmungen
Übergabe	Übergaben
Überlebenschance	Überlebenschancen
Überlegenheit	Überlegenheiten
Überlegung	Überlegungen
Übermacht	Übermächte
Übernachtung	Übernachtungen
Übernahme	Übernahmen
Überprüfung	Überprüfungen
Überraschung	Überraschungen
Überraschungsparty	Überraschungspartys
Überschwemmung	Überschwemmungen
Übersee	Überseen
Übersetzung	Übersetzungen
Überstunde	Überstunden
Übertragung	Übertragungen
Überwachung	Überwachungen
Überwachungskamera	Überwachungskameras
Überweisung	Überweisungen
Überzahl	—
Überzeugung	Überzeugungen
Übung	Übungen